tDate,amount,category,subCategory,Balance
2017-01-01,-12,Bank Commissions,Bank Hapoalom,-12
2017-01-01,-188,Gas,Delek,-200
2017-01-01,-169,Entertainments,Escape Room,-369
2017-01-01,-54,Supermarket,Shufersal,-423
2017-01-02,-180,Public Transport,Egged,-603
2017-01-02,-38,Restaurants,Falafel Shef,-641
2017-01-02,-47,TV,Netflix,-688
2017-01-04,-30,Newspapers,Yediot Aharonot,-718
2017-01-06,-171,Restaurants,BBB,-889
2017-01-06,-150,Cellular,Partner,-1039
2017-01-08,-39,Various Expenses,Alonit,-1078
2017-01-08,-185,Gas,Sonol,-1263
2017-01-09,-200,Cash withdrawals,ATM,-1463
2017-01-09,-79,Supermarket,Shufersal,-1542
2017-01-10,-597,Electricity,Electric Company,-2139
2017-01-10,-300,Saving,Exellence Investments,-2439
2017-01-10,-298,Cosmetics & Personal Care,SACARA,-2737
2017-01-10,7500,Income,Salary 1,4763
2017-01-10,6000,Income,Salary 2,10763
2017-01-10,-44,Various Expenses,Yellow,10719
2017-01-11,-3450,Mortgage / Rent,Avi Kuperman,7269
2017-01-12,-39,Public Transport,Egged,7230
2017-01-12,-554,Supermarket,Rami Levi,6676
2017-01-13,-26,Various Expenses,Kiosk Yossi,6650
2017-01-13,-198,Cosmetics & Personal Care,SACARA,6452
2017-01-14,-185,Water,Ein Cramim,6267
2017-01-14,-76,Various Expenses,So Good,6191
2017-01-15,-1742,Vacations,Bereshit,4449
2017-01-18,-400,Cash withdrawals,ATM,4049
2017-01-19,-65,Health Insurance / HMO,Clalit,3984
2017-01-19,-249,Health Insurance / HMO,Harel,3735
2017-01-21,-700,Property Tax,Carmiel Municipality,3035
2017-01-22,-200,Cash withdrawals,ATM,2835
2017-01-23,-147,Entertainments,Hot Movies,2688
2017-01-24,-380,Car Insurance,AIG,2308
2017-01-24,-80,Donations & Taxes,Latet,2228
2017-01-25,-103,Clothing,Fox,2125
2017-01-26,-177,Restaurants,Greg Coffee,1948
2017-01-26,-120,Education & Classes,Gym,1828
2017-01-26,-645,Education & Classes,Success - Private High-School,1183
2017-01-26,-633,Supermarket,Tiv Taam,550
2017-01-28,-657,Supermarket,Victory,-107
2017-01-29,-89,Internet,Bezeq,-196
2017-01-30,-165,Restaurants,Greg Coffee,-361
2017-01-31,-197,Gas,Delek,-558
2017-01-31,-199,"Pharmacy, Specialist Doctor",Good Pharm,-757
2017-01-31,-32,Public Transport,Kavim,-789
2017-02-01,-12,Bank Commissions,Bank Hapoalom,-801
2017-02-02,-201,Gas,Alon,-1002
2017-02-02,-180,Public Transport,Egged,-1182
2017-02-02,-47,TV,Netflix,-1229
2017-02-03,-221,Cosmetics & Personal Care,Super-Pharm,-1450
2017-02-04,-140,Clothing,Fox,-1590
2017-02-04,-37,Public Transport,Kavim,-1627
2017-02-04,-82,Various Expenses,Mifgash HaDerekh,-1709
2017-02-04,-30,Newspapers,Yediot Aharonot,-1739
2017-02-05,-632,Supermarket,Victory,-2371
2017-02-06,-150,Cellular,Partner,-2521
2017-02-07,-164,"Pharmacy, Specialist Doctor",Good Pharm,-2685
2017-02-07,-518,Supermarket,Tiv Taam,-3203
2017-02-07,-45,Supermarket,Victory,-3248
2017-02-08,-32,Public Transport,Kavim,-3280
2017-02-10,-194,Restaurants,Dominos Pizza,-3474
2017-02-10,-300,Saving,Exellence Investments,-3774
2017-02-10,7500,Income,Salary 1,3726
2017-02-10,6000,Income,Salary 2,9726
2017-02-10,-94,Various Expenses,Yellow,9632
2017-02-11,-3450,Mortgage / Rent,Avi Kuperman,6182
2017-02-11,-187,Restaurants,Vivino,5995
2017-02-13,-208,Gas,Paz,5787
2017-02-14,-30,Public Transport,Egged,5757
2017-02-14,-38,Restaurants,Hummus Eliyahu,5719
2017-02-16,-40,Restaurants,Falafel Shef,5679
2017-02-19,-65,Health Insurance / HMO,Clalit,5614
2017-02-19,-167,Entertainments,Escape Room,5447
2017-02-19,-249,Health Insurance / HMO,Harel,5198
2017-02-20,-605,Supermarket,Tiv Taam,4593
2017-02-21,-200,Cash withdrawals,ATM,4393
2017-02-21,-106,Various Expenses,Yellow,4287
2017-02-23,-235,"Pharmacy, Specialist Doctor",Good Pharm,4052
2017-02-23,-655,Supermarket,Victory,3397
2017-02-24,-380,Car Insurance,AIG,3017
2017-02-24,-229,Cosmetics & Personal Care,Super-Pharm,2788
2017-02-24,-80,Supermarket,Victory,2708
2017-02-25,-131,Entertainments,Escape Room,2577
2017-02-25,-192,Gas,Paz,2385
2017-02-26,-120,Education & Classes,Gym,2265
2017-02-26,-645,Education & Classes,Success - Private High-School,1620
2017-02-28,-400,Cash withdrawals,ATM,1220
2017-02-28,-89,Internet,Bezeq,1131
2017-02-28,-1020,Car Maintenance,Garage Carmiel,111
2017-02-28,-114,Various Expenses,Mifgash HaDerekh,-3
2017-02-28,-76,Supermarket,Tiv Taam,-79
2017-03-01,-17,Bank Commissions,Bank Hapoalom,-96
2017-03-01,-180,Public Transport,Egged,-276
2017-03-01,-44,Various Expenses,Mifgash HaDerekh,-320
2017-03-02,-30,Various Expenses,Alonit,-350
2017-03-02,-160,Entertainments,Hot Movies,-510
2017-03-02,-47,TV,Netflix,-557
2017-03-02,-639,Supermarket,Shufersal,-1196
2017-03-03,-203,Gas,Paz,-1399
2017-03-04,-30,Newspapers,Yediot Aharonot,-1429
2017-03-06,-150,Cellular,Partner,-1579
2017-03-07,-99,Various Expenses,Colbo Dani,-1678
2017-03-07,-529,Supermarket,Osher Ad,-2207
2017-03-08,-871,Electricity,Electric Company,-3078
2017-03-09,-567,Supermarket,Tiv Taam,-3645
2017-03-10,-211,Water,Ein Cramim,-3856
2017-03-10,-300,Saving,Exellence Investments,-4156
2017-03-10,7500,Income,Salary 1,3344
2017-03-10,6000,Income,Salary 2,9344
2017-03-11,-3450,Mortgage / Rent,Avi Kuperman,5894
2017-03-12,-205,Gas,Delek,5689
2017-03-13,-155,Restaurants,Dominos Pizza,5534
2017-03-13,-97,Donations & Taxes,IRS,5437
2017-03-13,-213,"Pharmacy, Specialist Doctor",Super-Pharm,5224
2017-03-14,-1264,Furniture & Household Equipment,Ace,3960
2017-03-15,-31,Public Transport,Kavim,3929
2017-03-17,-200,"Pharmacy, Specialist Doctor",Super-Pharm,3729
2017-03-18,-700,Property Tax,Carmiel Municipality,3029
2017-03-18,-36,Restaurants,Hummus Eliyahu,2993
2017-03-19,-65,Health Insurance / HMO,Clalit,2928
2017-03-19,-249,Health Insurance / HMO,Harel,2679
2017-03-19,-198,Gas,Paz,2481
2017-03-19,-75,Supermarket,Rami Levi,2406
2017-03-20,-200,Cash withdrawals,ATM,2206
2017-03-20,-400,Cash withdrawals,ATM,1806
2017-03-21,-146,Entertainments,Cinima City,1660
2017-03-23,-40,Restaurants,Falafel Shef,1620
2017-03-24,-380,Car Insurance,AIG,1240
2017-03-24,-154,Clothing,Crazy Line,1086
2017-03-26,-120,Education & Classes,Gym,966
2017-03-26,-658,Education & Classes,Success - Private High-School,308
2017-03-27,-30,Various Expenses,Yellow,278
2017-03-28,-160,Restaurants,BBB,118
2017-03-28,-59,Supermarket,Shufersal,59
2017-03-29,-89,Internet,Bezeq,-30
2017-03-31,-174,Entertainments,Cinima City,-204
2017-03-31,-83,Donations & Taxes,Pithon Lev,-287
2017-04-01,-12,Bank Commissions,Bank Hapoalom,-299
2017-04-01,-199,Restaurants,Dominos Pizza,-498
2017-04-01,-32,Public Transport,Egged,-530
2017-04-01,-171,"Pharmacy, Specialist Doctor",Super-Pharm,-701
2017-04-02,-135,Entertainments,Cinima City,-836
2017-04-02,-47,TV,Netflix,-883
2017-04-03,-180,Public Transport,Egged,-1063
2017-04-03,-105,Various Expenses,Yellow,-1168
2017-04-04,-286,Cosmetics & Personal Care,Be,-1454
2017-04-04,-104,Clothing,Tamnoon,-1558
2017-04-04,-30,Newspapers,Yediot Aharonot,-1588
2017-04-06,-400,Cash withdrawals,ATM,-1988
2017-04-06,-150,Cellular,Partner,-2138
2017-04-07,-44,Supermarket,Osher Ad,-2182
2017-04-07,-64,Supermarket,Osher Ad,-2246
2017-04-08,-207,Restaurants,BBB,-2453
2017-04-08,-192,Gas,Delek,-2645
2017-04-08,-205,Gas,Sonol,-2850
2017-04-09,-93,Various Expenses,Alonit,-2943
2017-04-09,-37,Restaurants,Hummus Eliyahu,-2980
2017-04-09,-734,Supermarket,Shufersal,-3714
2017-04-10,-300,Saving,Exellence Investments,-4014
2017-04-10,7500,Income,Salary 1,3486
2017-04-10,6000,Income,Salary 2,9486
2017-04-11,-3450,Mortgage / Rent,Avi Kuperman,6036
2017-04-12,-22,Public Transport,Egged,6014
2017-04-13,-400,Cash withdrawals,ATM,5614
2017-04-15,-202,Gas,Sonol,5412
2017-04-18,-19,Public Transport,Nativ Express,5393
2017-04-19,-65,Health Insurance / HMO,Clalit,5328
2017-04-19,-249,Health Insurance / HMO,Harel,5079
2017-04-20,-135,Entertainments,Escape Room,4944
2017-04-20,-90,Donations & Taxes,Pithon Lev,4854
2017-04-22,-183,Entertainments,Escape Room,4671
2017-04-23,-182,Restaurants,Dominos Pizza,4489
2017-04-24,-380,Car Insurance,AIG,4109
2017-04-26,-120,Education & Classes,Gym,3989
2017-04-26,-637,Education & Classes,Success - Private High-School,3352
2017-04-28,-42,Restaurants,Shawarma Shemesh,3310
2017-04-28,-778,Supermarket,Tiv Taam,2532
2017-04-29,-200,Cash withdrawals,ATM,2332
2017-04-29,-89,Internet,Bezeq,2243
2017-04-29,-364,Clothing,Castro,1879
2017-04-30,-98,Donations & Taxes,Latet,1781
2017-04-30,-788,Supermarket,Shufersal,993
2017-05-01,-12,Bank Commissions,Bank Hapoalom,981
2017-05-01,-180,Public Transport,Egged,801
2017-05-02,-47,TV,Netflix,754
2017-05-04,-206,Restaurants,BBB,548
2017-05-04,-30,Newspapers,Yediot Aharonot,518
2017-05-05,-204,Gas,Alon,314
2017-05-05,-32,Public Transport,Nativ Express,282
2017-05-06,-200,Cash withdrawals,ATM,82
2017-05-06,-179,Entertainments,Hot Movies,-97
2017-05-06,-150,Cellular,Partner,-247
2017-05-06,-633,Supermarket,Rami Levi,-880
2017-05-08,-513,Supermarket,Victory,-1393
2017-05-10,-400,Cash withdrawals,ATM,-1793
2017-05-10,-159,"Pharmacy, Specialist Doctor",Be,-1952
2017-05-10,-482,Electricity,Electric Company,-2434
2017-05-10,-300,Saving,Exellence Investments,-2734
2017-05-10,7500,Income,Salary 1,4766
2017-05-10,6000,Income,Salary 2,10766
2017-05-11,-3450,Mortgage / Rent,Avi Kuperman,7316
2017-05-12,-185,Gas,Alon,7131
2017-05-13,-180,Water,Ein Cramim,6951
2017-05-14,-39,Restaurants,Falafel Shef,6912
2017-05-14,-75,Supermarket,Rami Levi,6837
2017-05-15,-191,Restaurants,Greg Coffee,6646
2017-05-16,-163,Entertainments,Hot Movies,6483
2017-05-16,-136,Clothing,Mango,6347
2017-05-16,-105,Various Expenses,Yellow,6242
2017-05-17,-665,Supermarket,Tiv Taam,5577
2017-05-18,-700,Property Tax,Carmiel Municipality,4877
2017-05-19,-400,Cash withdrawals,ATM,4477
2017-05-19,-65,Health Insurance / HMO,Clalit,4412
2017-05-19,-249,Health Insurance / HMO,Harel,4163
2017-05-19,-653,Supermarket,Tiv Taam,3510
2017-05-20,-191,Gas,Alon,3319
2017-05-21,-36,Public Transport,Nativ Express,3283
2017-05-22,-76,Donations & Taxes,Pithon Lev,3207
2017-05-23,-200,Cash withdrawals,ATM,3007
2017-05-23,-243,Furniture & Household Equipment,Golf & Co,2764
2017-05-23,-167,Various Expenses,Kiosk Yossi,2597
2017-05-23,-274,Cosmetics & Personal Care,Super-Pharm,2323
2017-05-24,-380,Car Insurance,AIG,1943
2017-05-26,-120,Education & Classes,Gym,1823
2017-05-26,-638,Education & Classes,Success - Private High-School,1185
2017-05-28,-51,Various Expenses,Alonit,1134
2017-05-28,-88,Various Expenses,Colbo Dani,1046
2017-05-28,-101,Donations & Taxes,Paamonim,945
2017-05-29,-89,Internet,Bezeq,856
2017-05-29,-45,Supermarket,Tiv Taam,811
2017-06-01,-20,Bank Commissions,Bank Hapoalom,791
2017-06-02,-180,Public Transport,Egged,611
2017-06-02,-102,Donations & Taxes,IRS,509
2017-06-02,-47,TV,Netflix,462
2017-06-02,-558,Supermarket,Tiv Taam,-96
2017-06-03,-231,"Pharmacy, Specialist Doctor",Super-Pharm,-327
2017-06-04,-188,Entertainments,Hot Movies,-515
2017-06-04,-30,Newspapers,Yediot Aharonot,-545
2017-06-06,-150,Cellular,Partner,-695
2017-06-06,-621,Supermarket,Tiv Taam,-1316
2017-06-08,-100,Various Expenses,Yellow,-1416
2017-06-09,-400,Cash withdrawals,ATM,-1816
2017-06-10,-98,Various Expenses,Alonit,-1914
2017-06-10,-300,Saving,Exellence Investments,-2214
2017-06-10,7500,Income,Salary 1,5286
2017-06-10,6000,Income,Salary 2,11286
2017-06-10,-34,Supermarket,Victory,11252
2017-06-11,-3450,Mortgage / Rent,Avi Kuperman,7802
2017-06-12,-156,Various Expenses,Mifgash HaDerekh,7646
2017-06-14,-48,Various Expenses,Colbo Dani,7598
2017-06-14,-79,Supermarket,Tiv Taam,7519
2017-06-15,-14,Public Transport,Nativ Express,7505
2017-06-16,-16,Public Transport,Egged,7489
2017-06-16,-88,Donations & Taxes,IRS,7401
2017-06-17,-203,Gas,Paz,7198
2017-06-18,-141,Entertainments,Escape Room,7057
2017-06-19,-65,Health Insurance / HMO,Clalit,6992
2017-06-19,-249,Health Insurance / HMO,Harel,6743
2017-06-19,-172,Restaurants,Japanica,6571
2017-06-20,-108,Clothing,Renuar,6463
2017-06-21,-209,Gas,Alon,6254
2017-06-21,-104,Entertainments,Jimbori,6150
2017-06-21,-642,Supermarket,Shufersal,5508
2017-06-22,-200,Cash withdrawals,ATM,5308
2017-06-23,-36,Various Expenses,Kiosk Yossi,5272
2017-06-23,-188,Gas,Paz,5084
2017-06-24,-380,Car Insurance,AIG,4704
2017-06-24,-193,Restaurants,Dominos Pizza,4511
2017-06-24,-36,Restaurants,Shawarma Shemesh,4475
2017-06-26,-120,Education & Classes,Gym,4355
2017-06-26,-638,Education & Classes,Success - Private High-School,3717
2017-06-26,-81,Entertainments,SuperLand,3636
2017-06-28,-166,Restaurants,Vivino,3470
2017-06-29,-89,Internet,Bezeq,3381
2017-06-29,-161,Entertainments,Cinima City,3220
2017-06-29,-295,Cosmetics & Personal Care,Good Pharm,2925
2017-06-30,-14,Public Transport,Egged,2911
2017-06-30,-39,Restaurants,Shawarma Shemesh,2872
2017-07-01,-15,Bank Commissions,Bank Hapoalom,2857
2017-07-01,-98,Entertainments,I-Jump,2759
2017-07-02,-98,Entertainments,I-Jump,2661
2017-07-02,-47,TV,Netflix,2614
2017-07-03,-180,Public Transport,Egged,2434
2017-07-03,-186,Gas,Sonol,2248
2017-07-03,-184,Restaurants,Vivino,2064
2017-07-04,-30,Newspapers,Yediot Aharonot,2034
2017-07-05,-200,Cash withdrawals,ATM,1834
2017-07-05,-153,Restaurants,Vivino,1681
2017-07-06,-42,Restaurants,Falafel Shef,1639
2017-07-06,-150,Cellular,Partner,1489
2017-07-09,-48,Various Expenses,Colbo Dani,1441
2017-07-09,-37,Supermarket,Rami Levi,1404
2017-07-10,-629,Electricity,Electric Company,775
2017-07-10,-300,Saving,Exellence Investments,475
2017-07-10,7500,Income,Salary 1,7975
2017-07-10,6000,Income,Salary 2,13975
2017-07-11,-3450,Mortgage / Rent,Avi Kuperman,10525
2017-07-11,-2164,Vacations,Dan Panorama,8361
2017-07-12,-259,Water,Ein Cramim,8102
2017-07-12,-122,Clothing,Tamnoon,7980
2017-07-15,-400,Cash withdrawals,ATM,7580
2017-07-16,-156,Entertainments,Hot Movies,7424
2017-07-16,-20,Public Transport,Nativ Express,7404
2017-07-17,-245,"Pharmacy, Specialist Doctor",Good Pharm,7159
2017-07-17,-32,Supermarket,Shufersal,7127
2017-07-18,-700,Property Tax,Carmiel Municipality,6427
2017-07-18,-204,Restaurants,Greg Coffee,6223
2017-07-19,-68,Various Expenses,Alonit,6155
2017-07-19,-65,Health Insurance / HMO,Clalit,6090
2017-07-19,-249,Health Insurance / HMO,Harel,5841
2017-07-19,-88,Donations & Taxes,Pithon Lev,5753
2017-07-19,-549,Supermarket,Shufersal,5204
2017-07-20,-37,Supermarket,Tiv Taam,5167
2017-07-21,-42,Public Transport,Egged,5125
2017-07-21,-83,Donations & Taxes,IRS,5042
2017-07-21,-542,Supermarket,Osher Ad,4500
2017-07-22,-191,Gas,Alon,4309
2017-07-22,-16,Public Transport,Egged,4293
2017-07-22,-656,Supermarket,Shufersal,3637
2017-07-24,-380,Car Insurance,AIG,3257
2017-07-24,-167,Various Expenses,Yellow,3090
2017-07-26,-155,Entertainments,Escape Room,2935
2017-07-26,-172,Cosmetics & Personal Care,Good Pharm,2763
2017-07-26,-120,Education & Classes,Gym,2643
2017-07-26,-630,Education & Classes,Success - Private High-School,2013
2017-07-27,-101,Various Expenses,Alonit,1912
2017-07-28,-210,Gas,Paz,1702
2017-07-28,-35,Various Expenses,Yellow,1667
2017-07-29,-200,Cash withdrawals,ATM,1467
2017-07-29,-89,Internet,Bezeq,1378
2017-08-01,-18,Bank Commissions,Bank Hapoalom,1360
2017-08-02,-203,Gas,Delek,1157
2017-08-02,-180,Public Transport,Egged,977
2017-08-02,-47,TV,Netflix,930
2017-08-04,-201,"Pharmacy, Specialist Doctor",Good Pharm,729
2017-08-04,-30,Newspapers,Yediot Aharonot,699
2017-08-05,-49,Various Expenses,Yellow,650
2017-08-06,-150,Cellular,Partner,500
2017-08-07,-175,Restaurants,Japanica,325
2017-08-08,-400,Cash withdrawals,ATM,-75
2017-08-10,-300,Saving,Exellence Investments,-375
2017-08-10,-109,Various Expenses,Mifgash HaDerekh,-484
2017-08-10,-194,Gas,Paz,-678
2017-08-10,7500,Income,Salary 1,6822
2017-08-10,6000,Income,Salary 2,12822
2017-08-10,-558,Supermarket,Victory,12264
2017-08-11,-3450,Mortgage / Rent,Avi Kuperman,8814
2017-08-11,-28,Public Transport,Kavim,8786
2017-08-12,-121,Various Expenses,Mifgash HaDerekh,8665
2017-08-13,-267,Office Supplies,Ofiice Depot,8398
2017-08-13,-236,Cosmetics & Personal Care,SACARA,8162
2017-08-14,-200,Cash withdrawals,ATM,7962
2017-08-17,-234,"Pharmacy, Specialist Doctor",Good Pharm,7728
2017-08-19,-65,Health Insurance / HMO,Clalit,7663
2017-08-19,-249,Health Insurance / HMO,Harel,7414
2017-08-20,-192,Gas,Delek,7222
2017-08-20,-616,Supermarket,Rami Levi,6606
2017-08-20,-1359,Furniture & Household Equipment,Vardinon,5247
2017-08-21,-107,Clothing,Fox,5140
2017-08-22,-77,Supermarket,Rami Levi,5063
2017-08-22,-646,Supermarket,Tiv Taam,4417
2017-08-22,-72,Supermarket,Victory,4345
2017-08-24,-380,Car Insurance,AIG,3965
2017-08-24,-177,Entertainments,Hot Movies,3788
2017-08-25,-200,Cash withdrawals,ATM,3588
2017-08-25,-152,Restaurants,BBB,3436
2017-08-25,-85,Entertainments,SuperLand,3351
2017-08-26,-120,Education & Classes,Gym,3231
2017-08-26,-146,Entertainments,Hot Movies,3085
2017-08-26,-662,Education & Classes,Success - Private High-School,2423
2017-08-27,-83,Donations & Taxes,Pithon Lev,2340
2017-08-28,-100,Various Expenses,Alonit,2240
2017-08-28,-78,Various Expenses,Kiosk Yossi,2162
2017-08-29,-89,Internet,Bezeq,2073
2017-08-30,-37,Restaurants,Falafel Shef,2036
2017-08-30,-248,Cosmetics & Personal Care,Super-Pharm,1788
2017-09-01,-18,Bank Commissions,Bank Hapoalom,1770
2017-09-01,-180,Public Transport,Egged,1590
2017-09-02,-47,TV,Netflix,1543
2017-09-03,-141,Entertainments,Hot Movies,1402
2017-09-04,-30,Newspapers,Yediot Aharonot,1372
2017-09-05,-19,Public Transport,Egged,1353
2017-09-05,-75,Donations & Taxes,Paamonim,1278
2017-09-06,-65,Supermarket,Osher Ad,1213
2017-09-06,-150,Cellular,Partner,1063
2017-09-07,-153,Restaurants,Greg Coffee,910
2017-09-07,-593,Supermarket,Osher Ad,317
2017-09-07,-206,Gas,Sonol,111
2017-09-09,-400,Cash withdrawals,ATM,-289
2017-09-09,-79,Donations & Taxes,IRS,-368
2017-09-10,-200,Cash withdrawals,ATM,-568
2017-09-10,-300,Saving,Exellence Investments,-868
2017-09-10,7500,Income,Salary 1,6632
2017-09-10,6000,Income,Salary 2,12632
2017-09-11,-3450,Mortgage / Rent,Avi Kuperman,9182
2017-09-11,-762,Electricity,Electric Company,8420
2017-09-11,-223,Office Supplies,Kravitz,8197
2017-09-12,-246,Water,Ein Cramim,7951
2017-09-14,-208,Restaurants,Dominos Pizza,7743
2017-09-15,-242,"Pharmacy, Specialist Doctor",Good Pharm,7501
2017-09-16,-169,Restaurants,Greg Coffee,7332
2017-09-16,-622,Supermarket,Tiv Taam,6710
2017-09-17,-700,Property Tax,Carmiel Municipality,6010
2017-09-17,-103,Clothing,Renuar,5907
2017-09-18,-36,Public Transport,Kavim,5871
2017-09-18,-32,Various Expenses,Kiosk Yossi,5839
2017-09-19,-65,Health Insurance / HMO,Clalit,5774
2017-09-19,-249,Health Insurance / HMO,Harel,5525
2017-09-19,-527,Supermarket,Osher Ad,4998
2017-09-21,-208,Gas,Alon,4790
2017-09-21,-146,Entertainments,Escape Room,4644
2017-09-21,-26,Public Transport,Nativ Express,4618
2017-09-21,-72,Supermarket,Tiv Taam,4546
2017-09-22,-152,Entertainments,Cinima City,4394
2017-09-24,-380,Car Insurance,AIG,4014
2017-09-24,-35,Restaurants,Falafel Shef,3979
2017-09-25,-562,Supermarket,Rami Levi,3417
2017-09-26,-400,Cash withdrawals,ATM,3017
2017-09-26,-120,Education & Classes,Gym,2897
2017-09-26,-651,Education & Classes,Success - Private High-School,2246
2017-09-27,-195,Gas,Sonol,2051
2017-09-27,-27,Various Expenses,Yellow,2024
2017-09-28,-300,Cosmetics & Personal Care,Be,1724
2017-09-29,-89,Internet,Bezeq,1635
2017-10-01,-173,Various Expenses,Alonit,1462
2017-10-01,-20,Bank Commissions,Bank Hapoalom,1442
2017-10-01,-459,Clothing,Tamnoon,983
2017-10-02,-47,TV,Netflix,936
2017-10-02,-228,"Pharmacy, Specialist Doctor",Super-Pharm,708
2017-10-03,-180,Public Transport,Egged,528
2017-10-04,-231,Cosmetics & Personal Care,Be,297
2017-10-04,-64,Supermarket,Victory,233
2017-10-04,-30,Newspapers,Yediot Aharonot,203
2017-10-05,-774,Supermarket,Rami Levi,-571
2017-10-05,-135,Various Expenses,So Good,-706
2017-10-06,-150,Cellular,Partner,-856
2017-10-07,-171,Entertainments,Cinima City,-1027
2017-10-10,-59,Various Expenses,Alonit,-1086
2017-10-10,-200,Cash withdrawals,ATM,-1286
2017-10-10,-40,Various Expenses,Colbo Dani,-1326
2017-10-10,-300,Saving,Exellence Investments,-1626
2017-10-10,-156,Clothing,Mango,-1782
2017-10-10,7500,Income,Salary 1,5718
2017-10-10,6000,Income,Salary 2,11718
2017-10-10,-300,Cosmetics & Personal Care,Super-Pharm,11418
2017-10-11,-3450,Mortgage / Rent,Avi Kuperman,7968
2017-10-11,-38,Restaurants,Falafel Shef,7930
2017-10-13,-15,Public Transport,Egged,7915
2017-10-13,-14,Public Transport,Kavim,7901
2017-10-14,-295,Furniture & Household Equipment,Vardinon,7606
2017-10-17,-137,Various Expenses,Mifgash HaDerekh,7469
2017-10-19,-175,Restaurants,BBB,7294
2017-10-19,-65,Health Insurance / HMO,Clalit,7229
2017-10-19,-249,Health Insurance / HMO,Harel,6980
2017-10-20,-400,Cash withdrawals,ATM,6580
2017-10-20,-207,Gas,Paz,6373
2017-10-22,-196,Restaurants,Vivino,6177
2017-10-22,-155,Restaurants,Vivino,6022
2017-10-23,-831,Supermarket,Osher Ad,5191
2017-10-24,-380,Car Insurance,AIG,4811
2017-10-25,-97,Donations & Taxes,IRS,4714
2017-10-25,-196,Gas,Paz,4518
2017-10-26,-163,Entertainments,Cinima City,4355
2017-10-26,-120,Education & Classes,Gym,4235
2017-10-26,-632,Education & Classes,Success - Private High-School,3603
2017-10-28,-740,Supermarket,Victory,2863
2017-10-29,-89,Internet,Bezeq,2774
2017-10-30,-189,Gas,Alon,2585
2017-10-30,-50,Supermarket,Victory,2535
2017-10-31,-200,Cash withdrawals,ATM,2335
2017-11-01,-18,Bank Commissions,Bank Hapoalom,2317
2017-11-01,-134,Entertainments,Cinima City,2183
2017-11-02,-47,TV,Netflix,2136
2017-11-03,-159,Restaurants,BBB,1977
2017-11-03,-180,Public Transport,Egged,1797
2017-11-04,-30,Newspapers,Yediot Aharonot,1767
2017-11-05,-198,Gas,Delek,1569
2017-11-05,-30,Supermarket,Osher Ad,1539
2017-11-06,-179,Entertainments,Escape Room,1360
2017-11-06,-150,Cellular,Partner,1210
2017-11-07,-46,Various Expenses,Colbo Dani,1164
2017-11-07,-621,Supermarket,Shufersal,543
2017-11-08,-33,Supermarket,Rami Levi,510
2017-11-09,-475,Electricity,Electric Company,35
2017-11-09,-637,Supermarket,Tiv Taam,-602
2017-11-10,-300,Saving,Exellence Investments,-902
2017-11-10,7500,Income,Salary 1,6598
2017-11-10,6000,Income,Salary 2,12598
2017-11-11,-3450,Mortgage / Rent,Avi Kuperman,9148
2017-11-11,-194,Gas,Delek,8954
2017-11-13,-198,Water,Ein Cramim,8756
2017-11-17,-22,Public Transport,Nativ Express,8734
2017-11-18,-700,Property Tax,Carmiel Municipality,8034
2017-11-19,-65,Health Insurance / HMO,Clalit,7969
2017-11-19,-167,Clothing,Crazy Line,7802
2017-11-19,-249,Health Insurance / HMO,Harel,7553
2017-11-20,-400,Cash withdrawals,ATM,7153
2017-11-23,-173,Cosmetics & Personal Care,SACARA,6980
2017-11-24,-380,Car Insurance,AIG,6600
2017-11-24,-667,Supermarket,Osher Ad,5933
2017-11-24,-72,Supermarket,Osher Ad,5861
2017-11-25,-29,Various Expenses,Alonit,5832
2017-11-25,-196,Gas,Sonol,5636
2017-11-26,-41,Restaurants,Falafel Shef,5595
2017-11-26,-120,Education & Classes,Gym,5475
2017-11-26,-81,Donations & Taxes,Paamonim,5394
2017-11-26,-117,Various Expenses,So Good,5277
2017-11-26,-668,Education & Classes,Success - Private High-School,4609
2017-11-27,-204,Restaurants,Dominos Pizza,4405
2017-11-28,-179,Restaurants,Vivino,4226
2017-11-29,-89,Internet,Bezeq,4137
2017-11-29,-40,Restaurants,Shawarma Shemesh,4097
2017-11-30,-200,Cash withdrawals,ATM,3897
2017-11-30,-200,Cash withdrawals,ATM,3697
2017-11-30,-181,"Pharmacy, Specialist Doctor",Be,3516
2017-12-01,-16,Bank Commissions,Bank Hapoalom,3500
2017-12-02,-47,TV,Netflix,3453
2017-12-03,-180,Public Transport,Egged,3273
2017-12-03,-90,Donations & Taxes,Pithon Lev,3183
2017-12-04,-30,Newspapers,Yediot Aharonot,3153
2017-12-05,-132,Various Expenses,Mifgash HaDerekh,3021
2017-12-06,-150,Cellular,Partner,2871
2017-12-08,-275,Cosmetics & Personal Care,Super-Pharm,2596
2017-12-09,-553,Supermarket,Osher Ad,2043
2017-12-10,-247,"Pharmacy, Specialist Doctor",Be,1796
2017-12-10,-300,Saving,Exellence Investments,1496
2017-12-10,-47,Supermarket,Osher Ad,1449
2017-12-10,7500,Income,Salary 1,8949
2017-12-10,6000,Income,Salary 2,14949
2017-12-11,-3450,Mortgage / Rent,Avi Kuperman,11499
2017-12-11,-155,Restaurants,BBB,11344
2017-12-12,-25,Public Transport,Nativ Express,11319
2017-12-12,-188,Gas,Paz,11131
2017-12-13,-639,Supermarket,Rami Levi,10492
2017-12-14,-400,Cash withdrawals,ATM,10092
2017-12-16,-102,Donations & Taxes,Pithon Lev,9990
2017-12-18,-148,Entertainments,Cinima City,9842
2017-12-18,-198,Restaurants,Greg Coffee,9644
2017-12-19,-200,Cash withdrawals,ATM,9444
2017-12-19,-65,Health Insurance / HMO,Clalit,9379
2017-12-19,-249,Health Insurance / HMO,Harel,9130
2017-12-19,-60,Supermarket,Tiv Taam,9070
2017-12-21,-160,Clothing,Crazy Line,8910
2017-12-23,-564,Supermarket,Shufersal,8346
2017-12-24,-380,Car Insurance,AIG,7966
2017-12-24,-647,Supermarket,Rami Levi,7319
2017-12-25,-176,Office Supplies,Ofiice Depot,7143
2017-12-25,-124,Various Expenses,Yellow,7019
2017-12-26,-400,Cash withdrawals,ATM,6619
2017-12-26,-142,Entertainments,Cinima City,6477
2017-12-26,-120,Education & Classes,Gym,6357
2017-12-26,-634,Education & Classes,Success - Private High-School,5723
2017-12-28,-39,Public Transport,Kavim,5684
2017-12-29,-199,Restaurants,BBB,5485
2017-12-29,-89,Internet,Bezeq,5396
2017-12-29,-262,Cosmetics & Personal Care,Good Pharm,5134
2017-12-30,-167,Entertainments,Escape Room,4967
2017-12-30,-198,Gas,Paz,4769
2017-12-31,-146,Various Expenses,Alonit,4623
2017-12-31,-203,Gas,Delek,4420
2017-12-31,-39,Restaurants,Hummus Eliyahu,4381
2018-01-01,-12,Bank Commissions,Bank Hapoalom,4369
2018-01-02,-180,Public Transport,Egged,4189
2018-01-02,-47,TV,Netflix,4142
2018-01-03,-105,Various Expenses,Colbo Dani,4037
2018-01-03,-18,Public Transport,Egged,4019
2018-01-04,-200,Cash withdrawals,ATM,3819
2018-01-04,-30,Newspapers,Yediot Aharonot,3789
2018-01-06,-150,Cellular,Partner,3639
2018-01-06,-156,Restaurants,Vivino,3483
2018-01-08,-400,Cash withdrawals,ATM,3083
2018-01-09,-636,Electricity,Electric Company,2447
2018-01-10,-400,Cash withdrawals,ATM,2047
2018-01-10,-300,Saving,Exellence Investments,1747
2018-01-10,-148,Entertainments,Hot Movies,1599
2018-01-10,7500,Income,Salary 1,9099
2018-01-10,6000,Income,Salary 2,15099
2018-01-11,-3450,Mortgage / Rent,Avi Kuperman,11649
2018-01-11,-34,Supermarket,Tiv Taam,11615
2018-01-12,-622,Supermarket,Shufersal,10993
2018-01-13,-192,Gas,Paz,10801
2018-01-14,-210,Water,Ein Cramim,10591
2018-01-14,-153,Entertainments,Escape Room,10438
2018-01-14,-193,Gas,Sonol,10245
2018-01-18,-700,Property Tax,Carmiel Municipality,9545
2018-01-18,-155,Restaurants,Vivino,9390
2018-01-19,-65,Health Insurance / HMO,Clalit,9325
2018-01-19,-198,Gas,Delek,9127
2018-01-19,-171,"Pharmacy, Specialist Doctor",Good Pharm,8956
2018-01-19,-249,Health Insurance / HMO,Harel,8707
2018-01-19,-37,Restaurants,Hummus Eliyahu,8670
2018-01-21,-98,Donations & Taxes,Paamonim,8572
2018-01-21,-650,Supermarket,Shufersal,7922
2018-01-22,-54,Various Expenses,Colbo Dani,7868
2018-01-23,-542,Supermarket,Tiv Taam,7326
2018-01-24,-380,Car Insurance,AIG,6946
2018-01-26,-120,Education & Classes,Gym,6826
2018-01-26,-639,Education & Classes,Success - Private High-School,6187
2018-01-27,-560,Supermarket,Tiv Taam,5627
2018-01-27,-173,Restaurants,Vivino,5454
2018-01-28,-163,Clothing,Mango,5291
2018-01-29,-89,Internet,Bezeq,5202
2018-01-29,-40,Restaurants,Falafel Shef,5162
2018-01-29,-98,Various Expenses,Kiosk Yossi,5064
2018-01-30,-1722,Vacations,Leonardo,3342
2018-01-30,-129,Various Expenses,Yellow,3213
2018-01-31,-74,Supermarket,Victory,3139
2018-02-01,-17,Bank Commissions,Bank Hapoalom,3122
2018-02-01,-23,Public Transport,Egged,3099
2018-02-02,-47,TV,Netflix,3052
2018-02-02,-79,Supermarket,Osher Ad,2973
2018-02-03,-180,Public Transport,Egged,2793
2018-02-04,-30,Newspapers,Yediot Aharonot,2763
2018-02-06,-105,Various Expenses,Mifgash HaDerekh,2658
2018-02-06,-150,Cellular,Partner,2508
2018-02-07,-140,Clothing,Renuar,2368
2018-02-08,-200,Cash withdrawals,ATM,2168
2018-02-08,-197,Restaurants,Vivino,1971
2018-02-09,-400,Cash withdrawals,ATM,1571
2018-02-09,-140,Various Expenses,Mifgash HaDerekh,1431
2018-02-10,-300,Saving,Exellence Investments,1131
2018-02-10,7500,Income,Salary 1,8631
2018-02-10,6000,Income,Salary 2,14631
2018-02-11,-199,Gas,Alon,14432
2018-02-11,-3450,Mortgage / Rent,Avi Kuperman,10982
2018-02-12,-45,Supermarket,Rami Levi,10937
2018-02-13,-41,Restaurants,Falafel Shef,10896
2018-02-14,-195,Gas,Sonol,10701
2018-02-17,-26,Various Expenses,So Good,10675
2018-02-18,-400,Cash withdrawals,ATM,10275
2018-02-19,-143,Various Expenses,Alonit,10132
2018-02-19,-65,Health Insurance / HMO,Clalit,10067
2018-02-19,-37,Restaurants,Falafel Shef,10030
2018-02-19,-249,Health Insurance / HMO,Harel,9781
2018-02-19,-562,Supermarket,Shufersal,9219
2018-02-20,-168,Entertainments,Cinima City,9051
2018-02-21,-33,Public Transport,Nativ Express,9018
2018-02-21,-534,Supermarket,Shufersal,8484
2018-02-22,-203,Gas,Alon,8281
2018-02-24,-380,Car Insurance,AIG,7901
2018-02-24,-200,Cash withdrawals,ATM,7701
2018-02-24,-157,Entertainments,Escape Room,7544
2018-02-24,-107,Donations & Taxes,Latet,7437
2018-02-25,-1161,Car Maintenance,Garage Carmiel,6276
2018-02-25,-193,Restaurants,Japanica,6083
2018-02-26,-120,Education & Classes,Gym,5963
2018-02-26,-645,Education & Classes,Success - Private High-School,5318
2018-02-26,-563,Supermarket,Victory,4755
2018-02-28,-248,"Pharmacy, Specialist Doctor",Be,4507
2018-02-28,-89,Internet,Bezeq,4418
2018-02-28,-34,Supermarket,Rami Levi,4384
2018-03-01,-91,Various Expenses,Alonit,4293
2018-03-01,-19,Bank Commissions,Bank Hapoalom,4274
2018-03-01,-180,Public Transport,Egged,4094
2018-03-01,-36,Public Transport,Kavim,4058
2018-03-01,-62,Supermarket,Shufersal,3996
2018-03-02,-47,TV,Netflix,3949
2018-03-02,-190,Restaurants,Vivino,3759
2018-03-03,-200,Cash withdrawals,ATM,3559
2018-03-03,-546,Supermarket,Tiv Taam,3013
2018-03-04,-35,Restaurants,Shawarma Shemesh,2978
2018-03-04,-123,Various Expenses,So Good,2855
2018-03-04,-30,Newspapers,Yediot Aharonot,2825
2018-03-05,-51,Various Expenses,So Good,2774
2018-03-05,-623,Supermarket,Tiv Taam,2151
2018-03-06,-187,"Pharmacy, Specialist Doctor",Be,1964
2018-03-06,-150,Cellular,Partner,1814
2018-03-07,-879,Electricity,Electric Company,935
2018-03-08,-88,Donations & Taxes,Latet,847
2018-03-09,-179,Cosmetics & Personal Care,Be,668
2018-03-09,-191,Water,Ein Cramim,477
2018-03-10,-300,Saving,Exellence Investments,177
2018-03-10,7500,Income,Salary 1,7677
2018-03-10,6000,Income,Salary 2,13677
2018-03-11,-3450,Mortgage / Rent,Avi Kuperman,10227
2018-03-11,-249,"Pharmacy, Specialist Doctor",Good Pharm,9978
2018-03-11,-41,Supermarket,Osher Ad,9937
2018-03-12,-76,Supermarket,Shufersal,9861
2018-03-14,-181,Entertainments,Cinima City,9680
2018-03-16,-207,Gas,Paz,9473
2018-03-17,-187,Gas,Alon,9286
2018-03-17,-568,Supermarket,Osher Ad,8718
2018-03-18,-400,Cash withdrawals,ATM,8318
2018-03-18,-154,Restaurants,Japanica,8164
2018-03-19,-700,Property Tax,Carmiel Municipality,7464
2018-03-19,-65,Health Insurance / HMO,Clalit,7399
2018-03-19,-249,Health Insurance / HMO,Harel,7150
2018-03-22,-1288,Furniture & Household Equipment,Fox Home,5862
2018-03-24,-380,Car Insurance,AIG,5482
2018-03-24,-151,Cosmetics & Personal Care,Good Pharm,5331
2018-03-24,-149,Entertainments,Hot Movies,5182
2018-03-25,-193,Gas,Delek,4989
2018-03-26,-141,Entertainments,Cinima City,4848
2018-03-26,-120,Education & Classes,Gym,4728
2018-03-26,-647,Education & Classes,Success - Private High-School,4081
2018-03-28,-156,Various Expenses,Colbo Dani,3925
2018-03-29,-400,Cash withdrawals,ATM,3525
2018-03-29,-89,Internet,Bezeq,3436
2018-03-31,-181,Restaurants,Dominos Pizza,3255
2018-03-31,-146,Clothing,Tamnoon,3109
2018-04-01,-12,Bank Commissions,Bank Hapoalom,3097
2018-04-01,-348,Clothing,Renuar,2749
2018-04-02,-200,Cash withdrawals,ATM,2549
2018-04-02,-180,Public Transport,Egged,2369
2018-04-02,-141,Clothing,Mango,2228
2018-04-02,-47,TV,Netflix,2181
2018-04-03,-152,Entertainments,Escape Room,2029
2018-04-04,-30,Newspapers,Yediot Aharonot,1999
2018-04-06,-150,Cellular,Partner,1849
2018-04-06,-41,Supermarket,Tiv Taam,1808
2018-04-07,-814,Supermarket,Rami Levi,994
2018-04-09,-400,Cash withdrawals,ATM,594
2018-04-09,-185,Gas,Delek,409
2018-04-09,-30,Supermarket,Rami Levi,379
2018-04-10,-300,Saving,Exellence Investments,79
2018-04-10,-27,Public Transport,Nativ Express,52
2018-04-10,7500,Income,Salary 1,7552
2018-04-10,6000,Income,Salary 2,13552
2018-04-11,-200,Cash withdrawals,ATM,13352
2018-04-11,-3450,Mortgage / Rent,Avi Kuperman,9902
2018-04-11,-832,Supermarket,Osher Ad,9070
2018-04-12,-35,Public Transport,Nativ Express,9035
2018-04-15,-37,Restaurants,Falafel Shef,8998
2018-04-15,-190,Gas,Sonol,8808
2018-04-16,-177,Restaurants,Greg Coffee,8631
2018-04-17,-168,Cosmetics & Personal Care,Be,8463
2018-04-17,-72,Supermarket,Osher Ad,8391
2018-04-18,-400,Cash withdrawals,ATM,7991
2018-04-19,-65,Health Insurance / HMO,Clalit,7926
2018-04-19,-249,Health Insurance / HMO,Harel,7677
2018-04-20,-204,"Pharmacy, Specialist Doctor",Super-Pharm,7473
2018-04-21,-126,Various Expenses,Alonit,7347
2018-04-21,-167,Restaurants,Japanica,7180
2018-04-22,-174,Various Expenses,Yellow,7006
2018-04-23,-144,Entertainments,Hot Movies,6862
2018-04-24,-380,Car Insurance,AIG,6482
2018-04-25,-832,Supermarket,Victory,5650
2018-04-26,-120,Education & Classes,Gym,5530
2018-04-26,-644,Education & Classes,Success - Private High-School,4886
2018-04-27,-153,Entertainments,Hot Movies,4733
2018-04-28,-203,Gas,Paz,4530
2018-04-29,-89,Internet,Bezeq,4441
2018-05-01,-14,Bank Commissions,Bank Hapoalom,4427
2018-05-01,-180,Public Transport,Egged,4247
2018-05-02,-47,TV,Netflix,4200
2018-05-03,-40,Restaurants,Falafel Shef,4160
2018-05-03,-570,Supermarket,Shufersal,3590
2018-05-03,-78,Supermarket,Victory,3512
2018-05-04,-203,"Pharmacy, Specialist Doctor",Good Pharm,3309
2018-05-04,-30,Newspapers,Yediot Aharonot,3279
2018-05-06,-150,Cellular,Partner,3129
2018-05-06,-596,Supermarket,Tiv Taam,2533
2018-05-07,-41,Restaurants,Falafel Shef,2492
2018-05-07,-175,Entertainments,Hot Movies,2317
2018-05-07,-93,Donations & Taxes,Latet,2224
2018-05-08,-585,Supermarket,Shufersal,1639
2018-05-10,-423,Electricity,Electric Company,1216
2018-05-10,-300,Saving,Exellence Investments,916
2018-05-10,7500,Income,Salary 1,8416
2018-05-10,6000,Income,Salary 2,14416
2018-05-11,-3450,Mortgage / Rent,Avi Kuperman,10966
2018-05-14,-200,Cash withdrawals,ATM,10766
2018-05-14,-192,Water,Ein Cramim,10574
2018-05-14,-121,Various Expenses,Kiosk Yossi,10453
2018-05-14,-166,Clothing,Mango,10287
2018-05-14,-118,Various Expenses,So Good,10169
2018-05-15,-200,Cash withdrawals,ATM,9969
2018-05-15,-27,Public Transport,Egged,9942
2018-05-15,-92,Donations & Taxes,Paamonim,9850
2018-05-16,-188,Entertainments,Cinima City,9662
2018-05-17,-400,Cash withdrawals,ATM,9262
2018-05-17,-165,Various Expenses,Kiosk Yossi,9097
2018-05-17,-46,Supermarket,Tiv Taam,9051
2018-05-18,-148,Entertainments,Hot Movies,8903
2018-05-18,-103,Various Expenses,So Good,8800
2018-05-19,-65,Health Insurance / HMO,Clalit,8735
2018-05-19,-249,Health Insurance / HMO,Harel,8486
2018-05-20,-700,Property Tax,Carmiel Municipality,7786
2018-05-21,-197,Gas,Alon,7589
2018-05-23,-204,Gas,Delek,7385
2018-05-24,-380,Car Insurance,AIG,7005
2018-05-24,-183,Restaurants,Greg Coffee,6822
2018-05-24,-83,Various Expenses,Kiosk Yossi,6739
2018-05-26,-120,Education & Classes,Gym,6619
2018-05-26,-648,Education & Classes,Success - Private High-School,5971
2018-05-29,-159,"Pharmacy, Specialist Doctor",Be,5812
2018-05-29,-89,Internet,Bezeq,5723
2018-05-30,-190,Gas,Delek,5533
2018-05-30,-299,Furniture & Household Equipment,Vardinon,5234
2018-05-31,-200,Restaurants,Dominos Pizza,5034
2018-06-01,-15,Bank Commissions,Bank Hapoalom,5019
2018-06-01,-153,Restaurants,Vivino,4866
2018-06-02,-47,TV,Netflix,4819
2018-06-03,-180,Public Transport,Egged,4639
2018-06-04,-193,Gas,Delek,4446
2018-06-04,-30,Newspapers,Yediot Aharonot,4416
2018-06-05,-400,Cash withdrawals,ATM,4016
2018-06-05,-178,Cosmetics & Personal Care,SACARA,3838
2018-06-06,-150,Cellular,Partner,3688
2018-06-08,-177,Entertainments,Cinima City,3511
2018-06-10,-192,Gas,Alon,3319
2018-06-10,-300,Saving,Exellence Investments,3019
2018-06-10,-42,Restaurants,Falafel Shef,2977
2018-06-10,-101,Donations & Taxes,Latet,2876
2018-06-10,-210,Cosmetics & Personal Care,SACARA,2666
2018-06-10,7500,Income,Salary 1,10166
2018-06-10,6000,Income,Salary 2,16166
2018-06-11,-3450,Mortgage / Rent,Avi Kuperman,12716
2018-06-13,-158,Entertainments,Escape Room,12558
2018-06-15,-14,Public Transport,Kavim,12544
2018-06-16,-200,Cash withdrawals,ATM,12344
2018-06-16,-103,Donations & Taxes,IRS,12241
2018-06-16,-524,Supermarket,Tiv Taam,11717
2018-06-17,-175,Restaurants,Greg Coffee,11542
2018-06-18,-559,Supermarket,Osher Ad,10983
2018-06-18,-118,Various Expenses,So Good,10865
2018-06-18,-138,Various Expenses,Yellow,10727
2018-06-19,-65,Health Insurance / HMO,Clalit,10662
2018-06-19,-249,Health Insurance / HMO,Harel,10413
2018-06-19,-80,Entertainments,SuperLand,10333
2018-06-22,-79,Supermarket,Osher Ad,10254
2018-06-22,-34,Supermarket,Shufersal,10220
2018-06-22,-100,Entertainments,SuperLand,10120
2018-06-23,-140,Clothing,Fox,9980
2018-06-24,-380,Car Insurance,AIG,9600
2018-06-24,-400,Cash withdrawals,ATM,9200
2018-06-25,-200,Cash withdrawals,ATM,9000
2018-06-26,-228,"Pharmacy, Specialist Doctor",Be,8772
2018-06-26,-162,Entertainments,Cinima City,8610
2018-06-26,-120,Education & Classes,Gym,8490
2018-06-26,-665,Education & Classes,Success - Private High-School,7825
2018-06-26,-159,Restaurants,Vivino,7666
2018-06-27,-199,Gas,Alon,7467
2018-06-29,-89,Internet,Bezeq,7378
2018-06-30,-661,Supermarket,Osher Ad,6717
2018-07-01,-18,Bank Commissions,Bank Hapoalom,6699
2018-07-01,-180,Public Transport,Egged,6519
2018-07-01,-193,Gas,Sonol,6326
2018-07-02,-13,Public Transport,Nativ Express,6313
2018-07-02,-47,TV,Netflix,6266
2018-07-03,-47,Supermarket,Shufersal,6219
2018-07-03,-159,Clothing,Tamnoon,6060
2018-07-04,-169,Various Expenses,Alonit,5891
2018-07-04,-120,Entertainments,SuperLand,5771
2018-07-04,-30,Newspapers,Yediot Aharonot,5741
2018-07-05,-35,Public Transport,Nativ Express,5706
2018-07-06,-150,Cellular,Partner,5556
2018-07-07,-608,Electricity,Electric Company,4948
2018-07-07,-658,Supermarket,Rami Levi,4290
2018-07-07,-57,Supermarket,Shufersal,4233
2018-07-07,-198,Restaurants,Vivino,4035
2018-07-08,-222,"Pharmacy, Specialist Doctor",Be,3813
2018-07-09,-2309,Vacations,Bereshit,1504
2018-07-10,-268,Water,Ein Cramim,1236
2018-07-10,-300,Saving,Exellence Investments,936
2018-07-10,7500,Income,Salary 1,8436
2018-07-10,6000,Income,Salary 2,14436
2018-07-11,-3450,Mortgage / Rent,Avi Kuperman,10986
2018-07-12,-39,Restaurants,Shawarma Shemesh,10947
2018-07-12,-605,Supermarket,Victory,10342
2018-07-13,-83,Entertainments,Jimbori,10259
2018-07-15,-400,Cash withdrawals,ATM,9859
2018-07-15,-161,Entertainments,Escape Room,9698
2018-07-17,-200,Cash withdrawals,ATM,9498
2018-07-17,-190,Gas,Paz,9308
2018-07-18,-250,Cosmetics & Personal Care,SACARA,9058
2018-07-19,-65,Health Insurance / HMO,Clalit,8993
2018-07-19,-249,Health Insurance / HMO,Harel,8744
2018-07-20,-700,Property Tax,Carmiel Municipality,8044
2018-07-20,-145,Various Expenses,Kiosk Yossi,7899
2018-07-21,-207,Restaurants,Vivino,7692
2018-07-22,-22,Public Transport,Kavim,7670
2018-07-24,-380,Car Insurance,AIG,7290
2018-07-24,-61,Various Expenses,So Good,7229
2018-07-25,-63,Various Expenses,Colbo Dani,7166
2018-07-26,-120,Education & Classes,Gym,7046
2018-07-26,-501,Supermarket,Rami Levi,6545
2018-07-26,-639,Education & Classes,Success - Private High-School,5906
2018-07-28,-200,Cash withdrawals,ATM,5706
2018-07-28,-166,"Pharmacy, Specialist Doctor",Good Pharm,5540
2018-07-28,-175,Entertainments,Hot Movies,5365
2018-07-29,-89,Internet,Bezeq,5276
2018-07-29,-592,Supermarket,Shufersal,4684
2018-07-29,-61,Supermarket,Tiv Taam,4623
2018-07-30,-199,Gas,Alon,4424
2018-07-30,-196,Restaurants,BBB,4228
2018-08-01,-19,Bank Commissions,Bank Hapoalom,4209
2018-08-02,-47,TV,Netflix,4162
2018-08-02,-208,Gas,Paz,3954
2018-08-02,-53,Supermarket,Tiv Taam,3901
2018-08-03,-180,Public Transport,Egged,3721
2018-08-03,-181,Entertainments,Escape Room,3540
2018-08-04,-583,Supermarket,Victory,2957
2018-08-04,-30,Newspapers,Yediot Aharonot,2927
2018-08-05,-68,Supermarket,Victory,2859
2018-08-06,-150,Cellular,Partner,2709
2018-08-07,-151,Restaurants,Vivino,2558
2018-08-08,-209,Restaurants,Dominos Pizza,2349
2018-08-09,-92,Various Expenses,Colbo Dani,2257
2018-08-09,-199,Gas,Sonol,2058
2018-08-10,-300,Saving,Exellence Investments,1758
2018-08-10,7500,Income,Salary 1,9258
2018-08-10,6000,Income,Salary 2,15258
2018-08-11,-3450,Mortgage / Rent,Avi Kuperman,11808
2018-08-11,-205,Restaurants,BBB,11603
2018-08-11,-110,Donations & Taxes,Latet,11493
2018-08-11,-32,Public Transport,Nativ Express,11461
2018-08-12,-108,Donations & Taxes,Paamonim,11353
2018-08-13,-279,Cosmetics & Personal Care,Good Pharm,11074
2018-08-14,-194,Cosmetics & Personal Care,Good Pharm,10880
2018-08-14,-236,Office Supplies,Ofiice Depot,10644
2018-08-15,-400,Cash withdrawals,ATM,10244
2018-08-15,-140,Clothing,Castro,10104
2018-08-16,-36,Restaurants,Shawarma Shemesh,10068
2018-08-16,-654,Supermarket,Shufersal,9414
2018-08-17,-191,Gas,Alon,9223
2018-08-17,-109,Entertainments,SuperLand,9114
2018-08-18,-230,"Pharmacy, Specialist Doctor",Super-Pharm,8884
2018-08-19,-65,Health Insurance / HMO,Clalit,8819
2018-08-19,-249,Health Insurance / HMO,Harel,8570
2018-08-21,-640,Supermarket,Osher Ad,7930
2018-08-22,-29,Various Expenses,Yellow,7901
2018-08-24,-380,Car Insurance,AIG,7521
2018-08-25,-1495,Furniture & Household Equipment,Ace,6026
2018-08-25,-400,Cash withdrawals,ATM,5626
2018-08-26,-200,Cash withdrawals,ATM,5426
2018-08-26,-120,Education & Classes,Gym,5306
2018-08-26,-137,Entertainments,Hot Movies,5169
2018-08-26,-651,Education & Classes,Success - Private High-School,4518
2018-08-28,-137,Entertainments,Hot Movies,4381
2018-08-28,-65,Supermarket,Osher Ad,4316
2018-08-29,-89,Internet,Bezeq,4227
2018-08-30,-31,Various Expenses,Colbo Dani,4196
2018-08-31,-200,Cash withdrawals,ATM,3996
2018-08-31,-12,Public Transport,Nativ Express,3984
2018-09-01,-15,Bank Commissions,Bank Hapoalom,3969
2018-09-01,-55,Various Expenses,Yellow,3914
2018-09-02,-47,TV,Netflix,3867
2018-09-02,-64,Supermarket,Tiv Taam,3803
2018-09-03,-180,Public Transport,Egged,3623
2018-09-04,-30,Newspapers,Yediot Aharonot,3593
2018-09-05,-155,Entertainments,Cinima City,3438
2018-09-05,-194,Gas,Paz,3244
2018-09-06,-150,Cellular,Partner,3094
2018-09-07,-200,Cash withdrawals,ATM,2894
2018-09-08,-169,Entertainments,Escape Room,2725
2018-09-08,-38,Public Transport,Kavim,2687
2018-09-08,-175,Restaurants,Vivino,2512
2018-09-10,-300,Saving,Exellence Investments,2212
2018-09-10,-504,Supermarket,Osher Ad,1708
2018-09-10,-79,Donations & Taxes,Paamonim,1629
2018-09-10,7500,Income,Salary 1,9129
2018-09-10,6000,Income,Salary 2,15129
2018-09-11,-3450,Mortgage / Rent,Avi Kuperman,11679
2018-09-11,-780,Electricity,Electric Company,10899
2018-09-11,-558,Supermarket,Victory,10341
2018-09-12,-36,Restaurants,Falafel Shef,10305
2018-09-14,-400,Cash withdrawals,ATM,9905
2018-09-14,-241,Water,Ein Cramim,9664
2018-09-15,-188,Restaurants,Vivino,9476
2018-09-16,-227,Office Supplies,Ofiice Depot,9249
2018-09-17,-209,Cosmetics & Personal Care,Super-Pharm,9040
2018-09-17,-216,"Pharmacy, Specialist Doctor",Super-Pharm,8824
2018-09-18,-700,Property Tax,Carmiel Municipality,8124
2018-09-19,-65,Health Insurance / HMO,Clalit,8059
2018-09-19,-249,Health Insurance / HMO,Harel,7810
2018-09-19,-221,Cosmetics & Personal Care,Super-Pharm,7589
2018-09-20,-207,Gas,Delek,7382
2018-09-21,-189,Entertainments,Escape Room,7193
2018-09-23,-400,Cash withdrawals,ATM,6793
2018-09-23,-517,Supermarket,Tiv Taam,6276
2018-09-24,-380,Car Insurance,AIG,5896
2018-09-25,-63,Supermarket,Osher Ad,5833
2018-09-25,-54,Supermarket,Tiv Taam,5779
2018-09-26,-203,"Pharmacy, Specialist Doctor",Good Pharm,5576
2018-09-26,-120,Education & Classes,Gym,5456
2018-09-26,-659,Education & Classes,Success - Private High-School,4797
2018-09-26,-135,Various Expenses,Yellow,4662
2018-09-27,-209,Gas,Paz,4453
2018-09-28,-143,Various Expenses,So Good,4310
2018-09-28,-544,Supermarket,Tiv Taam,3766
2018-09-29,-89,Internet,Bezeq,3677
2018-09-30,-200,Cash withdrawals,ATM,3477
2018-09-30,-170,Clothing,Tamnoon,3307
2018-10-01,-200,Cash withdrawals,ATM,3107
2018-10-01,-19,Bank Commissions,Bank Hapoalom,3088
2018-10-01,-95,Donations & Taxes,Latet,2993
2018-10-02,-180,Public Transport,Egged,2813
2018-10-02,-47,TV,Netflix,2766
2018-10-03,-400,Cash withdrawals,ATM,2366
2018-10-03,-264,Furniture & Household Equipment,Max,2102
2018-10-04,-400,Cash withdrawals,ATM,1702
2018-10-04,-30,Newspapers,Yediot Aharonot,1672
2018-10-06,-19,Public Transport,Nativ Express,1653
2018-10-06,-150,Cellular,Partner,1503
2018-10-08,-200,Restaurants,Dominos Pizza,1303
2018-10-09,-139,Entertainments,Hot Movies,1164
2018-10-09,-38,Public Transport,Nativ Express,1126
2018-10-10,-300,Saving,Exellence Investments,826
2018-10-10,7500,Income,Salary 1,8326
2018-10-10,6000,Income,Salary 2,14326
2018-10-11,-3450,Mortgage / Rent,Avi Kuperman,10876
2018-10-11,-112,Clothing,Tamnoon,10764
2018-10-12,-766,Supermarket,Tiv Taam,9998
2018-10-13,-172,Restaurants,Greg Coffee,9826
2018-10-14,-209,Restaurants,Greg Coffee,9617
2018-10-15,-210,Gas,Alon,9407
2018-10-15,-40,Restaurants,Hummus Eliyahu,9367
2018-10-16,-157,"Pharmacy, Specialist Doctor",Be,9210
2018-10-17,-59,Various Expenses,Mifgash HaDerekh,9151
2018-10-18,-153,Various Expenses,Kiosk Yossi,8998
2018-10-18,-30,Supermarket,Osher Ad,8968
2018-10-19,-65,Health Insurance / HMO,Clalit,8903
2018-10-19,-249,Health Insurance / HMO,Harel,8654
2018-10-20,-153,Various Expenses,Yellow,8501
2018-10-21,-39,Restaurants,Shawarma Shemesh,8462
2018-10-22,-200,Cash withdrawals,ATM,8262
2018-10-23,-196,Gas,Alon,8066
2018-10-23,-482,Clothing,Tamnoon,7584
2018-10-24,-380,Car Insurance,AIG,7204
2018-10-25,-108,Donations & Taxes,Latet,7096
2018-10-26,-120,Education & Classes,Gym,6976
2018-10-26,-634,Education & Classes,Success - Private High-School,6342
2018-10-27,-72,Supermarket,Rami Levi,6270
2018-10-28,-818,Supermarket,Victory,5452
2018-10-29,-89,Internet,Bezeq,5363
2018-10-31,-130,Entertainments,Hot Movies,5233
2018-10-31,-745,Supermarket,Shufersal,4488
2018-10-31,-202,Gas,Sonol,4286
2018-11-01,-19,Bank Commissions,Bank Hapoalom,4267
2018-11-01,-180,Public Transport,Egged,4087
2018-11-02,-183,Entertainments,Cinima City,3904
2018-11-02,-175,Entertainments,Escape Room,3729
2018-11-02,-47,TV,Netflix,3682
2018-11-04,-586,Supermarket,Osher Ad,3096
2018-11-04,-164,"Pharmacy, Specialist Doctor",Super-Pharm,2932
2018-11-04,-30,Newspapers,Yediot Aharonot,2902
2018-11-05,-577,Supermarket,Osher Ad,2325
2018-11-06,-150,Cellular,Partner,2175
2018-11-07,-155,Restaurants,Dominos Pizza,2020
2018-11-08,-154,Entertainments,Escape Room,1866
2018-11-09,-200,Cash withdrawals,ATM,1666
2018-11-09,-34,Public Transport,Egged,1632
2018-11-09,-205,Gas,Paz,1427
2018-11-09,-169,Clothing,Renuar,1258
2018-11-10,-300,Saving,Exellence Investments,958
2018-11-10,-508,Supermarket,Osher Ad,450
2018-11-10,7500,Income,Salary 1,7950
2018-11-10,6000,Income,Salary 2,13950
2018-11-11,-400,Cash withdrawals,ATM,13550
2018-11-11,-3450,Mortgage / Rent,Avi Kuperman,10100
2018-11-11,-537,Electricity,Electric Company,9563
2018-11-12,-125,Various Expenses,Kiosk Yossi,9438
2018-11-12,-175,Restaurants,Vivino,9263
2018-11-13,-205,Water,Ein Cramim,9058
2018-11-16,-194,"Pharmacy, Specialist Doctor",Super-Pharm,8864
2018-11-19,-65,Health Insurance / HMO,Clalit,8799
2018-11-19,-249,Health Insurance / HMO,Harel,8550
2018-11-20,-194,Gas,Delek,8356
2018-11-20,-662,Supermarket,Victory,7694
2018-11-21,-700,Property Tax,Carmiel Municipality,6994
2018-11-21,-36,Restaurants,Shawarma Shemesh,6958
2018-11-24,-380,Car Insurance,AIG,6578
2018-11-24,-198,Gas,Delek,6380
2018-11-24,-70,Various Expenses,Mifgash HaDerekh,6310
2018-11-24,-52,Supermarket,Tiv Taam,6258
2018-11-26,-159,Restaurants,Dominos Pizza,6099
2018-11-26,-120,Education & Classes,Gym,5979
2018-11-26,-668,Education & Classes,Success - Private High-School,5311
2018-11-27,-40,Restaurants,Shawarma Shemesh,5271
2018-11-29,-89,Internet,Bezeq,5182
2018-11-30,-73,Supermarket,Shufersal,5109
2018-12-01,-200,Cash withdrawals,ATM,4909
2018-12-01,-18,Bank Commissions,Bank Hapoalom,4891
2018-12-02,-180,Public Transport,Egged,4711
2018-12-02,-47,TV,Netflix,4664
2018-12-03,-531,Supermarket,Tiv Taam,4133
2018-12-04,-38,Public Transport,Egged,4095
2018-12-04,-187,Entertainments,Hot Movies,3908
2018-12-04,-40,Restaurants,Hummus Eliyahu,3868
2018-12-04,-30,Newspapers,Yediot Aharonot,3838
2018-12-06,-205,Restaurants,Japanica,3633
2018-12-06,-150,Cellular,Partner,3483
2018-12-07,-400,Cash withdrawals,ATM,3083
2018-12-09,-82,Donations & Taxes,Pithon Lev,3001
2018-12-10,-300,Saving,Exellence Investments,2701
2018-12-10,-186,Gas,Paz,2515
2018-12-10,7500,Income,Salary 1,10015
2018-12-10,6000,Income,Salary 2,16015
2018-12-11,-3450,Mortgage / Rent,Avi Kuperman,12565
2018-12-11,-200,"Pharmacy, Specialist Doctor",Good Pharm,12365
2018-12-11,-629,Supermarket,Osher Ad,11736
2018-12-12,-173,Various Expenses,Mifgash HaDerekh,11563
2018-12-13,-530,Supermarket,Shufersal,11033
2018-12-14,-200,Cash withdrawals,ATM,10833
2018-12-14,-234,Cosmetics & Personal Care,Super-Pharm,10599
2018-12-14,-32,Supermarket,Tiv Taam,10567
2018-12-15,-189,Restaurants,Japanica,10378
2018-12-16,-15,Public Transport,Egged,10363
2018-12-17,-152,"Pharmacy, Specialist Doctor",Good Pharm,10211
2018-12-17,-105,Various Expenses,Yellow,10106
2018-12-18,-34,Public Transport,Kavim,10072
2018-12-19,-65,Health Insurance / HMO,Clalit,10007
2018-12-19,-249,Health Insurance / HMO,Harel,9758
2018-12-20,-190,Gas,Delek,9568
2018-12-21,-80,Various Expenses,Alonit,9488
2018-12-21,-147,Entertainments,Cinima City,9341
2018-12-21,-147,Clothing,Mango,9194
2018-12-24,-380,Car Insurance,AIG,8814
2018-12-26,-120,Education & Classes,Gym,8694
2018-12-26,-646,Education & Classes,Success - Private High-School,8048
2018-12-27,-90,Various Expenses,Alonit,7958
2018-12-27,-64,Supermarket,Osher Ad,7894
2018-12-27,-204,Gas,Paz,7690
2018-12-29,-89,Internet,Bezeq,7601
2018-12-30,-189,Office Supplies,Kravitz,7412
2019-01-01,-13,Bank Commissions,Bank Hapoalom,7399
2019-01-02,-180,Public Transport,Egged,7219
2019-01-02,-175,Entertainments,Hot Movies,7044
2019-01-02,-47,TV,Netflix,6997
2019-01-03,-400,Cash withdrawals,ATM,6597
2019-01-04,-547,Supermarket,Shufersal,6050
2019-01-04,-215,"Pharmacy, Specialist Doctor",Super-Pharm,5835
2019-01-04,-30,Newspapers,Yediot Aharonot,5805
2019-01-06,-208,Gas,Alon,5597
2019-01-06,-237,"Pharmacy, Specialist Doctor",Be,5360
2019-01-06,-99,Donations & Taxes,IRS,5261
2019-01-06,-150,Cellular,Partner,5111
2019-01-06,-35,Supermarket,Rami Levi,5076
2019-01-08,-17,Public Transport,Kavim,5059
2019-01-09,-581,Electricity,Electric Company,4478
2019-01-09,-36,Various Expenses,Kiosk Yossi,4442
2019-01-10,-300,Saving,Exellence Investments,4142
2019-01-10,-209,Gas,Paz,3933
2019-01-10,7500,Income,Salary 1,11433
2019-01-10,6000,Income,Salary 2,17433
2019-01-11,-3450,Mortgage / Rent,Avi Kuperman,13983
2019-01-11,-157,Cosmetics & Personal Care,Super-Pharm,13826
2019-01-12,-619,Supermarket,Rami Levi,13207
2019-01-13,-204,Water,Ein Cramim,13003
2019-01-13,-42,Restaurants,Hummus Eliyahu,12961
2019-01-13,-538,Supermarket,Rami Levi,12423
2019-01-14,-85,Donations & Taxes,Latet,12338
2019-01-14,-33,Public Transport,Nativ Express,12305
2019-01-19,-65,Health Insurance / HMO,Clalit,12240
2019-01-19,-249,Health Insurance / HMO,Harel,11991
2019-01-20,-700,Property Tax,Carmiel Municipality,11291
2019-01-21,-1914,Vacations,Leonardo,9377
2019-01-23,-200,Restaurants,Dominos Pizza,9177
2019-01-24,-380,Car Insurance,AIG,8797
2019-01-24,-159,Various Expenses,Yellow,8638
2019-01-26,-120,Education & Classes,Gym,8518
2019-01-26,-105,Various Expenses,Kiosk Yossi,8413
2019-01-26,-647,Education & Classes,Success - Private High-School,7766
2019-01-26,-65,Supermarket,Victory,7701
2019-01-27,-196,Gas,Alon,7505
2019-01-28,-200,Cash withdrawals,ATM,7305
2019-01-28,-175,Entertainments,Cinima City,7130
2019-01-28,-109,Clothing,Tamnoon,7021
2019-01-29,-89,Internet,Bezeq,6932
2019-01-29,-639,Supermarket,Rami Levi,6293
2019-01-31,-158,Restaurants,Greg Coffee,6135
2019-02-01,-20,Bank Commissions,Bank Hapoalom,6115
2019-02-01,-167,Entertainments,Cinima City,5948
2019-02-01,-197,Restaurants,Vivino,5751
2019-02-02,-180,Public Transport,Egged,5571
2019-02-02,-47,TV,Netflix,5524
2019-02-04,-30,Newspapers,Yediot Aharonot,5494
2019-02-05,-189,Entertainments,Escape Room,5305
2019-02-05,-33,Supermarket,Shufersal,5272
2019-02-06,-191,Restaurants,Dominos Pizza,5081
2019-02-06,-35,Restaurants,Falafel Shef,5046
2019-02-06,-40,Restaurants,Hummus Eliyahu,5006
2019-02-06,-150,Cellular,Partner,4856
2019-02-07,-400,Cash withdrawals,ATM,4456
2019-02-07,-196,Gas,Paz,4260
2019-02-07,-587,Supermarket,Tiv Taam,3673
2019-02-08,-514,Supermarket,Rami Levi,3159
2019-02-09,-145,Clothing,Renuar,3014
2019-02-09,-43,Supermarket,Tiv Taam,2971
2019-02-10,-200,Cash withdrawals,ATM,2771
2019-02-10,-300,Saving,Exellence Investments,2471
2019-02-10,-200,Gas,Paz,2271
2019-02-10,7500,Income,Salary 1,9771
2019-02-10,6000,Income,Salary 2,15771
2019-02-10,-37,Supermarket,Victory,15734
2019-02-11,-3450,Mortgage / Rent,Avi Kuperman,12284
2019-02-12,-594,Supermarket,Rami Levi,11690
2019-02-14,-400,Cash withdrawals,ATM,11290
2019-02-18,-77,Various Expenses,Kiosk Yossi,11213
2019-02-19,-65,Health Insurance / HMO,Clalit,11148
2019-02-19,-249,Health Insurance / HMO,Harel,10899
2019-02-19,-190,Gas,Paz,10709
2019-02-21,-19,Public Transport,Nativ Express,10690
2019-02-22,-117,Various Expenses,Colbo Dani,10573
2019-02-23,-37,Public Transport,Nativ Express,10536
2019-02-24,-380,Car Insurance,AIG,10156
2019-02-25,-184,Cosmetics & Personal Care,SACARA,9972
2019-02-26,-228,"Pharmacy, Specialist Doctor",Good Pharm,9744
2019-02-26,-120,Education & Classes,Gym,9624
2019-02-26,-667,Education & Classes,Success - Private High-School,8957
2019-02-27,-136,Entertainments,Escape Room,8821
2019-02-28,-89,Internet,Bezeq,8732
2019-02-28,-1013,Car Maintenance,Garage Carmiel,7719
2019-02-28,-547,Supermarket,Victory,7172
2019-03-01,-16,Bank Commissions,Bank Hapoalom,7156
2019-03-01,-180,Public Transport,Egged,6976
2019-03-01,-166,Entertainments,Hot Movies,6810
2019-03-02,-47,TV,Netflix,6763
2019-03-03,-75,Supermarket,Rami Levi,6688
2019-03-04,-30,Newspapers,Yediot Aharonot,6658
2019-03-05,-26,Public Transport,Egged,6632
2019-03-05,-92,Donations & Taxes,IRS,6540
2019-03-05,-202,Restaurants,Vivino,6338
2019-03-06,-126,Various Expenses,Colbo Dani,6212
2019-03-06,-145,Entertainments,Hot Movies,6067
2019-03-06,-150,Cellular,Partner,5917
2019-03-08,-46,Various Expenses,So Good,5871
2019-03-09,-53,Various Expenses,Alonit,5818
2019-03-09,-228,"Pharmacy, Specialist Doctor",Be,5590
2019-03-09,-40,Supermarket,Rami Levi,5550
2019-03-09,-563,Supermarket,Shufersal,4987
2019-03-10,-214,Water,Ein Cramim,4773
2019-03-10,-806,Electricity,Electric Company,3967
2019-03-10,-300,Saving,Exellence Investments,3667
2019-03-10,7500,Income,Salary 1,11167
2019-03-10,6000,Income,Salary 2,17167
2019-03-11,-3450,Mortgage / Rent,Avi Kuperman,13717
2019-03-11,-96,Donations & Taxes,Paamonim,13621
2019-03-11,-288,Cosmetics & Personal Care,SACARA,13333
2019-03-19,-200,Cash withdrawals,ATM,13133
2019-03-19,-700,Property Tax,Carmiel Municipality,12433
2019-03-19,-65,Health Insurance / HMO,Clalit,12368
2019-03-19,-143,Clothing,Crazy Line,12225
2019-03-19,-249,Health Insurance / HMO,Harel,11976
2019-03-20,-1472,Furniture & Household Equipment,Home Center,10504
2019-03-20,-567,Supermarket,Osher Ad,9937
2019-03-20,-196,Gas,Paz,9741
2019-03-21,-207,Gas,Alon,9534
2019-03-22,-400,Cash withdrawals,ATM,9134
2019-03-22,-35,Restaurants,Falafel Shef,9099
2019-03-23,-196,Cosmetics & Personal Care,SACARA,8903
2019-03-24,-380,Car Insurance,AIG,8523
2019-03-24,-173,Restaurants,BBB,8350
2019-03-25,-618,Supermarket,Osher Ad,7732
2019-03-26,-120,Education & Classes,Gym,7612
2019-03-26,-641,Education & Classes,Success - Private High-School,6971
2019-03-27,-133,Entertainments,Hot Movies,6838
2019-03-27,-640,Supermarket,Rami Levi,6198
2019-03-28,-400,Cash withdrawals,ATM,5798
2019-03-28,-199,Gas,Paz,5599
2019-03-29,-89,Internet,Bezeq,5510
2019-03-29,-37,Restaurants,Shawarma Shemesh,5473
2019-03-30,-73,Various Expenses,Yellow,5400
2019-04-01,-65,Various Expenses,Alonit,5335
2019-04-01,-20,Bank Commissions,Bank Hapoalom,5315
2019-04-02,-47,TV,Netflix,5268
2019-04-02,-38,Restaurants,Shawarma Shemesh,5230
2019-04-03,-180,Public Transport,Egged,5050
2019-04-04,-30,Newspapers,Yediot Aharonot,5020
2019-04-05,-13,Public Transport,Egged,5007
2019-04-06,-301,Clothing,Fox,4706
2019-04-06,-160,Cosmetics & Personal Care,Good Pharm,4546
2019-04-06,-172,Various Expenses,Mifgash HaDerekh,4374
2019-04-06,-150,Cellular,Partner,4224
2019-04-07,-163,"Pharmacy, Specialist Doctor",Be,4061
2019-04-07,-85,Donations & Taxes,IRS,3976
2019-04-08,-224,"Pharmacy, Specialist Doctor",Super-Pharm,3752
2019-04-10,-300,Saving,Exellence Investments,3452
2019-04-10,7500,Income,Salary 1,10952
2019-04-10,6000,Income,Salary 2,16952
2019-04-11,-3450,Mortgage / Rent,Avi Kuperman,13502
2019-04-12,-400,Cash withdrawals,ATM,13102
2019-04-12,-843,Supermarket,Osher Ad,12259
2019-04-14,-200,Cash withdrawals,ATM,12059
2019-04-14,-76,Donations & Taxes,Paamonim,11983
2019-04-15,-724,Supermarket,Rami Levi,11259
2019-04-17,-209,Gas,Delek,11050
2019-04-19,-174,Entertainments,Cinima City,10876
2019-04-19,-65,Health Insurance / HMO,Clalit,10811
2019-04-19,-185,Gas,Delek,10626
2019-04-19,-249,Health Insurance / HMO,Harel,10377
2019-04-19,-184,Entertainments,Hot Movies,10193
2019-04-20,-158,Clothing,Tamnoon,10035
2019-04-21,-295,Cosmetics & Personal Care,Be,9740
2019-04-22,-73,Supermarket,Tiv Taam,9667
2019-04-24,-380,Car Insurance,AIG,9287
2019-04-24,-199,Gas,Paz,9088
2019-04-25,-193,Restaurants,Vivino,8895
2019-04-26,-120,Education & Classes,Gym,8775
2019-04-26,-636,Education & Classes,Success - Private High-School,8139
2019-04-29,-89,Internet,Bezeq,8050
2019-04-29,-161,Restaurants,Vivino,7889
2019-04-30,-400,Cash withdrawals,ATM,7489
2019-04-30,-828,Supermarket,Rami Levi,6661
2019-04-30,-44,Supermarket,Victory,6617
2019-05-01,-12,Bank Commissions,Bank Hapoalom,6605
2019-05-01,-180,Public Transport,Egged,6425
2019-05-01,-206,Restaurants,Greg Coffee,6219
2019-05-02,-400,Cash withdrawals,ATM,5819
2019-05-02,-244,"Pharmacy, Specialist Doctor",Good Pharm,5575
2019-05-02,-47,TV,Netflix,5528
2019-05-04,-40,Supermarket,Shufersal,5488
2019-05-04,-30,Newspapers,Yediot Aharonot,5458
2019-05-05,-38,Public Transport,Nativ Express,5420
2019-05-06,-80,Donations & Taxes,IRS,5340
2019-05-06,-150,Cellular,Partner,5190
2019-05-06,-72,Supermarket,Rami Levi,5118
2019-05-06,-65,Supermarket,Victory,5053
2019-05-08,-137,Clothing,Tamnoon,4916
2019-05-09,-515,Electricity,Electric Company,4401
2019-05-10,-200,Cash withdrawals,ATM,4201
2019-05-10,-167,Cosmetics & Personal Care,Be,4034
2019-05-10,-300,Saving,Exellence Investments,3734
2019-05-10,7500,Income,Salary 1,11234
2019-05-10,6000,Income,Salary 2,17234
2019-05-11,-3450,Mortgage / Rent,Avi Kuperman,13784
2019-05-13,-198,"Pharmacy, Specialist Doctor",Be,13586
2019-05-13,-166,Various Expenses,Kiosk Yossi,13420
2019-05-14,-203,Water,Ein Cramim,13217
2019-05-16,-657,Supermarket,Victory,12560
2019-05-18,-501,Supermarket,Osher Ad,12059
2019-05-19,-700,Property Tax,Carmiel Municipality,11359
2019-05-19,-65,Health Insurance / HMO,Clalit,11294
2019-05-19,-249,Health Insurance / HMO,Harel,11045
2019-05-20,-35,Restaurants,Shawarma Shemesh,11010
2019-05-21,-547,Supermarket,Shufersal,10463
2019-05-21,-190,Gas,Sonol,10273
2019-05-22,-81,Various Expenses,Colbo Dani,10192
2019-05-23,-400,Cash withdrawals,ATM,9792
2019-05-24,-380,Car Insurance,AIG,9412
2019-05-25,-193,Gas,Paz,9219
2019-05-25,-653,Supermarket,Tiv Taam,8566
2019-05-26,-271,Furniture & Household Equipment,Ace,8295
2019-05-26,-120,Education & Classes,Gym,8175
2019-05-26,-667,Education & Classes,Success - Private High-School,7508
2019-05-26,-118,Various Expenses,Yellow,7390
2019-05-27,-178,Entertainments,Cinima City,7212
2019-05-28,-200,Cash withdrawals,ATM,7012
2019-05-28,-188,Restaurants,Vivino,6824
2019-05-29,-209,Gas,Alon,6615
2019-05-29,-89,Internet,Bezeq,6526
2019-05-29,-162,Restaurants,Japanica,6364
2019-05-30,-133,Entertainments,Cinima City,6231
2019-05-31,-187,Entertainments,Hot Movies,6044
2019-06-01,-19,Bank Commissions,Bank Hapoalom,6025
2019-06-01,-520,Supermarket,Shufersal,5505
2019-06-02,-47,TV,Netflix,5458
2019-06-02,-535,Supermarket,Shufersal,4923
2019-06-03,-180,Public Transport,Egged,4743
2019-06-03,-118,Entertainments,Yamit 2000,4625
2019-06-04,-61,Supermarket,Tiv Taam,4564
2019-06-04,-30,Newspapers,Yediot Aharonot,4534
2019-06-05,-200,Cash withdrawals,ATM,4334
2019-06-05,-202,"Pharmacy, Specialist Doctor",Be,4132
2019-06-05,-194,Restaurants,Vivino,3938
2019-06-06,-150,Cellular,Partner,3788
2019-06-06,-36,Restaurants,Shawarma Shemesh,3752
2019-06-07,-127,Clothing,Mango,3625
2019-06-09,-25,Public Transport,Nativ Express,3600
2019-06-10,-300,Saving,Exellence Investments,3300
2019-06-10,7500,Income,Salary 1,10800
2019-06-10,6000,Income,Salary 2,16800
2019-06-11,-3450,Mortgage / Rent,Avi Kuperman,13350
2019-06-12,-135,Entertainments,Cinima City,13215
2019-06-12,-57,Various Expenses,Colbo Dani,13158
2019-06-12,-71,Supermarket,Osher Ad,13087
2019-06-13,-400,Cash withdrawals,ATM,12687
2019-06-15,-222,Cosmetics & Personal Care,Good Pharm,12465
2019-06-15,-191,Gas,Paz,12274
2019-06-17,-103,Various Expenses,Colbo Dani,12171
2019-06-17,-27,Public Transport,Egged,12144
2019-06-18,-124,Various Expenses,Colbo Dani,12020
2019-06-19,-65,Health Insurance / HMO,Clalit,11955
2019-06-19,-249,Health Insurance / HMO,Harel,11706
2019-06-20,-194,Gas,Paz,11512
2019-06-23,-598,Supermarket,Rami Levi,10914
2019-06-24,-380,Car Insurance,AIG,10534
2019-06-24,-200,Cash withdrawals,ATM,10334
2019-06-24,-192,"Pharmacy, Specialist Doctor",Super-Pharm,10142
2019-06-25,-148,Entertainments,Cinima City,9994
2019-06-26,-120,Education & Classes,Gym,9874
2019-06-26,-643,Education & Classes,Success - Private High-School,9231
2019-06-27,-155,Restaurants,Dominos Pizza,9076
2019-06-27,-13,Public Transport,Nativ Express,9063
2019-06-28,-210,Restaurants,Greg Coffee,8853
2019-06-28,-31,Various Expenses,So Good,8822
2019-06-29,-89,Internet,Bezeq,8733
2019-06-30,-400,Cash withdrawals,ATM,8333
2019-06-30,-47,Various Expenses,Colbo Dani,8286
2019-06-30,-203,Gas,Delek,8083
2019-06-30,-621,Supermarket,Rami Levi,7462
2019-07-01,-20,Bank Commissions,Bank Hapoalom,7442
2019-07-02,-180,Public Transport,Egged,7262
2019-07-02,-33,Various Expenses,Kiosk Yossi,7229
2019-07-02,-47,TV,Netflix,7182
2019-07-03,-632,Supermarket,Rami Levi,6550
2019-07-04,-124,Various Expenses,Mifgash HaDerekh,6426
2019-07-04,-189,Gas,Paz,6237
2019-07-04,-627,Supermarket,Rami Levi,5610
2019-07-04,-30,Newspapers,Yediot Aharonot,5580
2019-07-06,-182,"Pharmacy, Specialist Doctor",Good Pharm,5398
2019-07-06,-13,Public Transport,Kavim,5385
2019-07-06,-150,Cellular,Partner,5235
2019-07-06,-102,Entertainments,Yamit 2000,5133
2019-07-07,-193,Gas,Alon,4940
2019-07-07,-161,Restaurants,Dominos Pizza,4779
2019-07-07,-549,Supermarket,Shufersal,4230
2019-07-08,-186,Entertainments,Cinima City,4044
2019-07-08,-567,Electricity,Electric Company,3477
2019-07-08,-61,Various Expenses,Yellow,3416
2019-07-08,-96,Various Expenses,Yellow,3320
2019-07-09,-276,Water,Ein Cramim,3044
2019-07-10,-300,Saving,Exellence Investments,2744
2019-07-10,7500,Income,Salary 1,10244
2019-07-10,6000,Income,Salary 2,16244
2019-07-11,-3450,Mortgage / Rent,Avi Kuperman,12794
2019-07-11,-183,Entertainments,Escape Room,12611
2019-07-12,-101,Entertainments,Jimbori,12510
2019-07-13,-200,Cash withdrawals,ATM,12310
2019-07-13,-597,Supermarket,Shufersal,11713
2019-07-14,-145,Clothing,Renuar,11568
2019-07-16,-156,Various Expenses,Colbo Dani,11412
2019-07-18,-700,Property Tax,Carmiel Municipality,10712
2019-07-19,-65,Health Insurance / HMO,Clalit,10647
2019-07-19,-249,Health Insurance / HMO,Harel,10398
2019-07-24,-380,Car Insurance,AIG,10018
2019-07-24,-2347,Vacations,Dan Panorama,7671
2019-07-24,-108,Donations & Taxes,IRS,7563
2019-07-25,-170,Entertainments,Hot Movies,7393
2019-07-25,-39,Supermarket,Shufersal,7354
2019-07-25,-53,Supermarket,Victory,7301
2019-07-26,-120,Education & Classes,Gym,7181
2019-07-26,-48,Supermarket,Shufersal,7133
2019-07-26,-659,Education & Classes,Success - Private High-School,6474
2019-07-27,-400,Cash withdrawals,ATM,6074
2019-07-27,-40,Restaurants,Hummus Eliyahu,6034
2019-07-28,-186,Gas,Alon,5848
2019-07-29,-200,Cash withdrawals,ATM,5648
2019-07-29,-154,Restaurants,BBB,5494
2019-07-29,-89,Internet,Bezeq,5405
2019-07-29,-188,"Pharmacy, Specialist Doctor",Good Pharm,5217
2019-07-30,-190,Restaurants,Vivino,5027
2019-08-01,-13,Bank Commissions,Bank Hapoalom,5014
2019-08-01,-63,Supermarket,Victory,4951
2019-08-02,-186,Gas,Alon,4765
2019-08-02,-47,TV,Netflix,4718
2019-08-03,-161,Restaurants,Dominos Pizza,4557
2019-08-03,-180,Public Transport,Egged,4377
2019-08-03,-40,Restaurants,Falafel Shef,4337
2019-08-03,-207,"Pharmacy, Specialist Doctor",Good Pharm,4130
2019-08-04,-30,Newspapers,Yediot Aharonot,4100
2019-08-05,-87,Various Expenses,Alonit,4013
2019-08-06,-200,Cash withdrawals,ATM,3813
2019-08-06,-74,Various Expenses,Kiosk Yossi,3739
2019-08-06,-150,Cellular,Partner,3589
2019-08-08,-542,Supermarket,Shufersal,3047
2019-08-08,-1288,Furniture & Household Equipment,Vardinon,1759
2019-08-10,-300,Saving,Exellence Investments,1459
2019-08-10,7500,Income,Salary 1,8959
2019-08-10,6000,Income,Salary 2,14959
2019-08-11,-3450,Mortgage / Rent,Avi Kuperman,11509
2019-08-11,-70,Various Expenses,Colbo Dani,11439
2019-08-16,-195,Gas,Alon,11244
2019-08-17,-26,Various Expenses,Alonit,11218
2019-08-17,-56,Various Expenses,Mifgash HaDerekh,11162
2019-08-17,-295,Office Supplies,Ofiice Depot,10867
2019-08-17,-622,Supermarket,Tiv Taam,10245
2019-08-19,-65,Health Insurance / HMO,Clalit,10180
2019-08-19,-249,Health Insurance / HMO,Harel,9931
2019-08-19,-37,Restaurants,Hummus Eliyahu,9894
2019-08-20,-400,Cash withdrawals,ATM,9494
2019-08-20,-150,Entertainments,Escape Room,9344
2019-08-20,-170,Restaurants,Greg Coffee,9174
2019-08-20,-109,Entertainments,I-Jump,9065
2019-08-21,-38,Public Transport,Egged,9027
2019-08-21,-91,Donations & Taxes,Latet,8936
2019-08-22,-207,Gas,Sonol,8729
2019-08-22,-81,Entertainments,SuperLand,8648
2019-08-23,-167,Entertainments,Cinima City,8481
2019-08-24,-380,Car Insurance,AIG,8101
2019-08-24,-62,Supermarket,Tiv Taam,8039
2019-08-25,-200,Cash withdrawals,ATM,7839
2019-08-25,-187,Restaurants,BBB,7652
2019-08-25,-168,Clothing,Tamnoon,7484
2019-08-26,-120,Education & Classes,Gym,7364
2019-08-26,-651,Education & Classes,Success - Private High-School,6713
2019-08-29,-89,Internet,Bezeq,6624
2019-08-29,-176,"Pharmacy, Specialist Doctor",Good Pharm,6448
2019-08-30,-506,Supermarket,Osher Ad,5942
2019-08-30,-52,Supermarket,Shufersal,5890
2019-09-01,-13,Bank Commissions,Bank Hapoalom,5877
2019-09-02,-180,Public Transport,Egged,5697
2019-09-02,-47,TV,Netflix,5650
2019-09-02,-539,Supermarket,Rami Levi,5111
2019-09-03,-503,Supermarket,Rami Levi,4608
2019-09-04,-65,Supermarket,Rami Levi,4543
2019-09-04,-30,Newspapers,Yediot Aharonot,4513
2019-09-05,-142,Entertainments,Hot Movies,4371
2019-09-05,-615,Supermarket,Shufersal,3756
2019-09-06,-102,Donations & Taxes,Paamonim,3654
2019-09-06,-150,Cellular,Partner,3504
2019-09-09,-832,Electricity,Electric Company,2672
2019-09-10,-300,Saving,Exellence Investments,2372
2019-09-10,7500,Income,Salary 1,9872
2019-09-10,6000,Income,Salary 2,15872
2019-09-11,-3450,Mortgage / Rent,Avi Kuperman,12422
2019-09-11,-187,Gas,Delek,12235
2019-09-13,-207,Gas,Delek,12028
2019-09-13,-265,Water,Ein Cramim,11763
2019-09-15,-135,Clothing,Fox,11628
2019-09-15,-182,"Pharmacy, Specialist Doctor",Good Pharm,11446
2019-09-15,-77,Donations & Taxes,IRS,11369
2019-09-16,-400,Cash withdrawals,ATM,10969
2019-09-17,-152,Restaurants,BBB,10817
2019-09-17,-700,Property Tax,Carmiel Municipality,10117
2019-09-18,-17,Public Transport,Egged,10100
2019-09-19,-65,Health Insurance / HMO,Clalit,10035
2019-09-19,-249,Health Insurance / HMO,Harel,9786
2019-09-21,-244,"Pharmacy, Specialist Doctor",Be,9542
2019-09-21,-26,Public Transport,Egged,9516
2019-09-23,-200,Cash withdrawals,ATM,9316
2019-09-23,-191,Restaurants,Greg Coffee,9125
2019-09-24,-380,Car Insurance,AIG,8745
2019-09-24,-208,Gas,Paz,8537
2019-09-25,-26,Various Expenses,Colbo Dani,8511
2019-09-25,-141,Entertainments,Escape Room,8370
2019-09-26,-120,Education & Classes,Gym,8250
2019-09-26,-258,Office Supplies,Kravitz,7992
2019-09-26,-642,Education & Classes,Success - Private High-School,7350
2019-09-27,-70,Various Expenses,So Good,7280
2019-09-28,-35,Restaurants,Falafel Shef,7245
2019-09-29,-400,Cash withdrawals,ATM,6845
2019-09-29,-89,Internet,Bezeq,6756
2019-09-29,-205,Restaurants,Japanica,6551
2019-09-29,-40,Restaurants,Shawarma Shemesh,6511
2019-09-30,-200,Cash withdrawals,ATM,6311
2019-09-30,-65,Supermarket,Tiv Taam,6246
2019-10-01,-200,Cash withdrawals,ATM,6046
2019-10-01,-200,Cash withdrawals,ATM,5846
2019-10-01,-14,Bank Commissions,Bank Hapoalom,5832
2019-10-01,-180,Entertainments,Escape Room,5652
2019-10-02,-47,TV,Netflix,5605
2019-10-03,-180,Public Transport,Egged,5425
2019-10-03,-762,Supermarket,Osher Ad,4663
2019-10-03,-835,Supermarket,Rami Levi,3828
2019-10-04,-40,Restaurants,Hummus Eliyahu,3788
2019-10-04,-30,Newspapers,Yediot Aharonot,3758
2019-10-06,-150,Cellular,Partner,3608
2019-10-07,-30,Public Transport,Nativ Express,3578
2019-10-09,-400,Cash withdrawals,ATM,3178
2019-10-10,-272,Cosmetics & Personal Care,Be,2906
2019-10-10,-169,"Pharmacy, Specialist Doctor",Be,2737
2019-10-10,-153,Entertainments,Escape Room,2584
2019-10-10,-300,Saving,Exellence Investments,2284
2019-10-10,7500,Income,Salary 1,9784
2019-10-10,6000,Income,Salary 2,15784
2019-10-11,-3450,Mortgage / Rent,Avi Kuperman,12334
2019-10-11,-89,Donations & Taxes,Latet,12245
2019-10-12,-177,Entertainments,Hot Movies,12068
2019-10-12,-189,Gas,Sonol,11879
2019-10-13,-759,Supermarket,Osher Ad,11120
2019-10-13,-68,Supermarket,Rami Levi,11052
2019-10-15,-85,Various Expenses,So Good,10967
2019-10-17,-43,Supermarket,Tiv Taam,10924
2019-10-17,-70,Supermarket,Victory,10854
2019-10-18,-36,Restaurants,Hummus Eliyahu,10818
2019-10-19,-144,Various Expenses,Alonit,10674
2019-10-19,-65,Health Insurance / HMO,Clalit,10609
2019-10-19,-249,Health Insurance / HMO,Harel,10360
2019-10-19,-748,Supermarket,Shufersal,9612
2019-10-20,-109,Clothing,Renuar,9503
2019-10-21,-417,Clothing,Mango,9086
2019-10-21,-155,Restaurants,Vivino,8931
2019-10-22,-292,Furniture & Household Equipment,Fox Home,8639
2019-10-23,-157,Restaurants,BBB,8482
2019-10-23,-29,Various Expenses,So Good,8453
2019-10-24,-380,Car Insurance,AIG,8073
2019-10-26,-163,"Pharmacy, Specialist Doctor",Good Pharm,7910
2019-10-26,-120,Education & Classes,Gym,7790
2019-10-26,-195,Gas,Paz,7595
2019-10-26,-669,Education & Classes,Success - Private High-School,6926
2019-10-28,-27,Public Transport,Egged,6899
2019-10-28,-198,Gas,Sonol,6701
2019-10-29,-89,Internet,Bezeq,6612
2019-10-30,-73,Various Expenses,Mifgash HaDerekh,6539
2019-10-30,-96,Donations & Taxes,Paamonim,6443
2019-11-01,-145,Various Expenses,Alonit,6298
2019-11-01,-19,Bank Commissions,Bank Hapoalom,6279
2019-11-01,-145,Clothing,Crazy Line,6134
2019-11-01,-180,Public Transport,Egged,5954
2019-11-02,-47,TV,Netflix,5907
2019-11-03,-178,Entertainments,Escape Room,5729
2019-11-03,-38,Restaurants,Falafel Shef,5691
2019-11-03,-69,Various Expenses,Kiosk Yossi,5622
2019-11-04,-177,Restaurants,Greg Coffee,5445
2019-11-04,-30,Newspapers,Yediot Aharonot,5415
2019-11-05,-82,Donations & Taxes,Pithon Lev,5333
2019-11-06,-208,Gas,Alon,5125
2019-11-06,-150,Cellular,Partner,4975
2019-11-07,-534,Electricity,Electric Company,4441
2019-11-08,-36,Public Transport,Nativ Express,4405
2019-11-09,-139,Entertainments,Cinima City,4266
2019-11-09,-190,Gas,Delek,4076
2019-11-10,-300,Saving,Exellence Investments,3776
2019-11-10,-68,Supermarket,Rami Levi,3708
2019-11-10,7500,Income,Salary 1,11208
2019-11-10,6000,Income,Salary 2,17208
2019-11-11,-3450,Mortgage / Rent,Avi Kuperman,13758
2019-11-12,-204,Water,Ein Cramim,13554
2019-11-13,-200,Cash withdrawals,ATM,13354
2019-11-14,-632,Supermarket,Victory,12722
2019-11-17,-193,Gas,Alon,12529
2019-11-17,-574,Supermarket,Shufersal,11955
2019-11-18,-41,Various Expenses,Mifgash HaDerekh,11914
2019-11-19,-65,Health Insurance / HMO,Clalit,11849
2019-11-19,-163,Restaurants,Dominos Pizza,11686
2019-11-19,-249,Health Insurance / HMO,Harel,11437
2019-11-19,-192,"Pharmacy, Specialist Doctor",Super-Pharm,11245
2019-11-21,-700,Property Tax,Carmiel Municipality,10545
2019-11-22,-123,Various Expenses,Mifgash HaDerekh,10422
2019-11-24,-380,Car Insurance,AIG,10042
2019-11-24,-64,Supermarket,Victory,9978
2019-11-26,-120,Education & Classes,Gym,9858
2019-11-26,-81,Various Expenses,Mifgash HaDerekh,9777
2019-11-26,-632,Education & Classes,Success - Private High-School,9145
2019-11-27,-197,Restaurants,Dominos Pizza,8948
2019-11-27,-650,Supermarket,Osher Ad,8298
2019-11-29,-89,Internet,Bezeq,8209
2019-11-30,-400,Cash withdrawals,ATM,7809
2019-11-30,-618,Supermarket,Tiv Taam,7191
2019-11-30,-78,Supermarket,Tiv Taam,7113
2019-12-01,-14,Bank Commissions,Bank Hapoalom,7099
2019-12-01,-624,Supermarket,Tiv Taam,6475
2019-12-02,-180,Public Transport,Egged,6295
2019-12-02,-47,TV,Netflix,6248
2019-12-02,-190,Gas,Paz,6058
2019-12-03,-201,Gas,Delek,5857
2019-12-04,-30,Newspapers,Yediot Aharonot,5827
2019-12-06,-25,Public Transport,Nativ Express,5802
2019-12-06,-150,Cellular,Partner,5652
2019-12-07,-204,Restaurants,BBB,5448
2019-12-08,-400,Cash withdrawals,ATM,5048
2019-12-09,-29,Public Transport,Kavim,5019
2019-12-10,-300,Saving,Exellence Investments,4719
2019-12-10,-53,Various Expenses,Kiosk Yossi,4666
2019-12-10,-21,Public Transport,Nativ Express,4645
2019-12-10,7500,Income,Salary 1,12145
2019-12-10,6000,Income,Salary 2,18145
2019-12-11,-3450,Mortgage / Rent,Avi Kuperman,14695
2019-12-11,-184,Cosmetics & Personal Care,SACARA,14511
2019-12-13,-200,Cash withdrawals,ATM,14311
2019-12-14,-138,Entertainments,Cinima City,14173
2019-12-14,-178,Restaurants,Greg Coffee,13995
2019-12-14,-580,Supermarket,Osher Ad,13415
2019-12-14,-594,Supermarket,Tiv Taam,12821
2019-12-15,-576,Supermarket,Osher Ad,12245
2019-12-17,-206,"Pharmacy, Specialist Doctor",Be,12039
2019-12-18,-55,Supermarket,Tiv Taam,11984
2019-12-19,-65,Health Insurance / HMO,Clalit,11919
2019-12-19,-249,Health Insurance / HMO,Harel,11670
2019-12-19,-45,Supermarket,Victory,11625
2019-12-21,-39,Restaurants,Shawarma Shemesh,11586
2019-12-22,-244,Cosmetics & Personal Care,SACARA,11342
2019-12-23,-158,Entertainments,Cinima City,11184
2019-12-23,-56,Various Expenses,Mifgash HaDerekh,11128
2019-12-24,-380,Car Insurance,AIG,10748
2019-12-24,-163,Office Supplies,Ofiice Depot,10585
2019-12-24,-188,Gas,Sonol,10397
2019-12-25,-38,Supermarket,Victory,10359
2019-12-26,-120,Education & Classes,Gym,10239
2019-12-26,-665,Education & Classes,Success - Private High-School,9574
2019-12-28,-144,Entertainments,Hot Movies,9430
2019-12-28,-86,Various Expenses,Mifgash HaDerekh,9344
2019-12-29,-89,Internet,Bezeq,9255
2019-12-30,-200,Cash withdrawals,ATM,9055
2019-12-31,-78,Various Expenses,Colbo Dani,8977
2019-12-31,-127,Clothing,Fox,8850
2019-12-31,-192,"Pharmacy, Specialist Doctor",Good Pharm,8658
2020-01-01,-17,Bank Commissions,Bank Hapoalom,8641
2020-01-02,-180,Public Transport,Egged,8461
2020-01-02,-47,TV,Netflix,8414
2020-01-03,-400,Cash withdrawals,ATM,8014
2020-01-03,-189,Gas,Sonol,7825
2020-01-04,-55,Supermarket,Tiv Taam,7770
2020-01-04,-30,Newspapers,Yediot Aharonot,7740
2020-01-06,-150,Cellular,Partner,7590
2020-01-06,-36,Supermarket,Tiv Taam,7554
2020-01-07,-121,Clothing,Crazy Line,7433
2020-01-07,-614,Electricity,Electric Company,6819
2020-01-08,-186,Entertainments,Hot Movies,6633
2020-01-08,-552,Supermarket,Osher Ad,6081
2020-01-08,-83,Donations & Taxes,Paamonim,5998
2020-01-09,-190,Water,Ein Cramim,5808
2020-01-10,-300,Saving,Exellence Investments,5508
2020-01-10,7500,Income,Salary 1,13008
2020-01-10,6000,Income,Salary 2,19008
2020-01-11,-400,Cash withdrawals,ATM,18608
2020-01-11,-3450,Mortgage / Rent,Avi Kuperman,15158
2020-01-14,-205,Restaurants,Japanica,14953
2020-01-15,-43,Supermarket,Victory,14910
2020-01-16,-200,Cash withdrawals,ATM,14710
2020-01-16,-166,Restaurants,Greg Coffee,14544
2020-01-17,-30,Public Transport,Nativ Express,14514
2020-01-19,-65,Health Insurance / HMO,Clalit,14449
2020-01-19,-249,Health Insurance / HMO,Harel,14200
2020-01-20,-1962,Vacations,Dan Panorama,12238
2020-01-20,-205,Gas,Delek,12033
2020-01-20,-39,Restaurants,Hummus Eliyahu,11994
2020-01-21,-700,Property Tax,Carmiel Municipality,11294
2020-01-21,-175,Various Expenses,Mifgash HaDerekh,11119
2020-01-23,-183,Restaurants,Japanica,10936
2020-01-23,-568,Supermarket,Victory,10368
2020-01-24,-380,Car Insurance,AIG,9988
2020-01-24,-201,Gas,Delek,9787
2020-01-25,-35,Various Expenses,Alonit,9752
2020-01-26,-146,Entertainments,Cinima City,9606
2020-01-26,-120,Education & Classes,Gym,9486
2020-01-26,-657,Education & Classes,Success - Private High-School,8829
2020-01-29,-187,"Pharmacy, Specialist Doctor",Be,8642
2020-01-29,-89,Internet,Bezeq,8553
2020-01-30,-22,Public Transport,Egged,8531
2020-01-30,-665,Supermarket,Victory,7866
2020-01-31,-574,Supermarket,Victory,7292
2020-02-01,-17,Bank Commissions,Bank Hapoalom,7275
2020-02-02,-190,Gas,Alon,7085
2020-02-02,-26,Public Transport,Egged,7059
2020-02-02,-47,TV,Netflix,7012
2020-02-03,-133,Clothing,Crazy Line,6879
2020-02-03,-180,Public Transport,Egged,6699
2020-02-04,-30,Newspapers,Yediot Aharonot,6669
2020-02-05,-56,Supermarket,Osher Ad,6613
2020-02-06,-150,Cellular,Partner,6463
2020-02-08,-956,Car Maintenance,Garage Carmiel,5507
2020-02-08,-75,Various Expenses,So Good,5432
2020-02-09,-210,Restaurants,Dominos Pizza,5222
2020-02-09,-206,Gas,Paz,5016
2020-02-10,-200,Gas,Delek,4816
2020-02-10,-300,Saving,Exellence Investments,4516
2020-02-10,7500,Income,Salary 1,12016
2020-02-10,6000,Income,Salary 2,18016
2020-02-11,-3450,Mortgage / Rent,Avi Kuperman,14566
2020-02-11,-606,Supermarket,Victory,13960
2020-02-12,-200,Cash withdrawals,ATM,13760
2020-02-14,-33,Public Transport,Kavim,13727
2020-02-14,-13,Public Transport,Kavim,13714
2020-02-15,-184,Restaurants,BBB,13530
2020-02-16,-164,Various Expenses,Mifgash HaDerekh,13366
2020-02-18,-37,Restaurants,Hummus Eliyahu,13329
2020-02-19,-400,Cash withdrawals,ATM,12929
2020-02-19,-65,Health Insurance / HMO,Clalit,12864
2020-02-19,-249,Health Insurance / HMO,Harel,12615
2020-02-21,-87,Donations & Taxes,Paamonim,12528
2020-02-21,-669,Supermarket,Shufersal,11859
2020-02-22,-400,Cash withdrawals,ATM,11459
2020-02-23,-50,Supermarket,Victory,11409
2020-02-24,-380,Car Insurance,AIG,11029
2020-02-26,-120,Education & Classes,Gym,10909
2020-02-26,-653,Education & Classes,Success - Private High-School,10256
2020-02-27,-154,Restaurants,Greg Coffee,10102
2020-02-27,-507,Supermarket,Victory,9595
2020-02-27,-615,Supermarket,Victory,8980
2020-02-28,-191,"Pharmacy, Specialist Doctor",Be,8789
2020-02-28,-89,Internet,Bezeq,8700
2020-02-28,-134,Entertainments,Cinima City,8566
2020-02-28,-170,Entertainments,Escape Room,8396
2020-03-01,-18,Bank Commissions,Bank Hapoalom,8378
2020-03-02,-163,Restaurants,BBB,8215
2020-03-02,-180,Public Transport,Egged,8035
2020-03-02,-47,TV,Netflix,7988
2020-03-02,-529,Supermarket,Rami Levi,7459
2020-03-02,-198,Gas,Sonol,7261
2020-03-03,-15,Public Transport,Egged,7246
2020-03-03,-1449,Furniture & Household Equipment,Home Center,5797
2020-03-04,-30,Newspapers,Yediot Aharonot,5767
2020-03-06,-29,Public Transport,Kavim,5738
2020-03-06,-150,Cellular,Partner,5588
2020-03-07,-400,Cash withdrawals,ATM,5188
2020-03-07,-822,Electricity,Electric Company,4366
2020-03-08,-552,Supermarket,Shufersal,3814
2020-03-09,-36,Restaurants,Hummus Eliyahu,3778
2020-03-09,-53,Supermarket,Osher Ad,3725
2020-03-10,-198,Water,Ein Cramim,3527
2020-03-10,-300,Saving,Exellence Investments,3227
2020-03-10,7500,Income,Salary 1,10727
2020-03-10,6000,Income,Salary 2,16727
2020-03-11,-3450,Mortgage / Rent,Avi Kuperman,13277
2020-03-11,-509,Supermarket,Tiv Taam,12768
2020-03-14,-150,Restaurants,Dominos Pizza,12618
2020-03-14,-79,Supermarket,Shufersal,12539
2020-03-15,-71,Various Expenses,Alonit,12468
2020-03-16,-99,Donations & Taxes,Pithon Lev,12369
2020-03-19,-65,Health Insurance / HMO,Clalit,12304
2020-03-19,-249,Health Insurance / HMO,Harel,12055
2020-03-20,-700,Property Tax,Carmiel Municipality,11355
2020-03-20,-194,Gas,Paz,11161
2020-03-21,-131,Entertainments,Cinima City,11030
2020-03-22,-178,Restaurants,Greg Coffee,10852
2020-03-24,-380,Car Insurance,AIG,10472
2020-03-24,-200,Cash withdrawals,ATM,10272
2020-03-24,-161,"Pharmacy, Specialist Doctor",Be,10111
2020-03-24,-184,Entertainments,Cinima City,9927
2020-03-26,-186,Gas,Delek,9741
2020-03-26,-120,Education & Classes,Gym,9621
2020-03-26,-652,Education & Classes,Success - Private High-School,8969
2020-03-27,-400,Cash withdrawals,ATM,8569
2020-03-27,-39,Various Expenses,Colbo Dani,8530
2020-03-27,-45,Supermarket,Osher Ad,8485
2020-03-28,-38,Restaurants,Falafel Shef,8447
2020-03-28,-12,Public Transport,Nativ Express,8435
2020-03-28,-162,Clothing,Tamnoon,8273
2020-03-29,-89,Internet,Bezeq,8184
2020-03-29,-232,"Pharmacy, Specialist Doctor",Super-Pharm,7952
2020-04-01,-20,Bank Commissions,Bank Hapoalom,7932
2020-04-01,-180,Public Transport,Egged,7752
2020-04-01,-90,Various Expenses,Mifgash HaDerekh,7662
2020-04-02,-146,Entertainments,Hot Movies,7516
2020-04-02,-47,TV,Netflix,7469
2020-04-03,-30,Public Transport,Egged,7439
2020-04-04,-143,Various Expenses,Kiosk Yossi,7296
2020-04-04,-30,Newspapers,Yediot Aharonot,7266
2020-04-05,-400,Cash withdrawals,ATM,6866
2020-04-06,-150,Cellular,Partner,6716
2020-04-07,-181,Restaurants,BBB,6535
2020-04-07,-200,Gas,Paz,6335
2020-04-09,-200,Cash withdrawals,ATM,6135
2020-04-10,-300,Saving,Exellence Investments,5835
2020-04-10,6000,Income,Social Security,11835
2020-04-10,6000,Income,Salary 2,17835
2020-04-11,-3450,Mortgage / Rent,Avi Kuperman,14385
2020-04-11,-166,Entertainments,Hot Movies,14219
2020-04-11,-38,Restaurants,Hummus Eliyahu,14181
2020-04-12,-72,Supermarket,Victory,14109
2020-04-13,-739,Supermarket,Victory,13370
2020-04-17,-222,"Pharmacy, Specialist Doctor",Super-Pharm,13148
2020-04-18,-339,Clothing,Fox,12809
2020-04-18,-196,Restaurants,Japanica,12613
2020-04-18,-27,Public Transport,Kavim,12586
2020-04-19,-107,Clothing,Castro,12479
2020-04-19,-65,Health Insurance / HMO,Clalit,12414
2020-04-19,-249,Health Insurance / HMO,Harel,12165
2020-04-20,-839,Supermarket,Osher Ad,11326
2020-04-22,-62,Supermarket,Shufersal,11264
2020-04-24,-380,Car Insurance,AIG,10884
2020-04-24,-145,Entertainments,Escape Room,10739
2020-04-24,-42,Restaurants,Hummus Eliyahu,10697
2020-04-25,-200,Cash withdrawals,ATM,10497
2020-04-25,-204,Gas,Delek,10293
2020-04-25,-196,Gas,Sonol,10097
2020-04-26,-120,Education & Classes,Gym,9977
2020-04-26,-647,Education & Classes,Success - Private High-School,9330
2020-04-29,-89,Internet,Bezeq,9241
2020-04-29,-781,Supermarket,Tiv Taam,8460
2020-05-01,-14,Bank Commissions,Bank Hapoalom,8446
2020-05-01,-205,Restaurants,Dominos Pizza,8241
2020-05-01,-246,Cosmetics & Personal Care,Super-Pharm,7995
2020-05-02,-180,Public Transport,Egged,7815
2020-05-02,-148,Clothing,Fox,7667
2020-05-02,-47,TV,Netflix,7620
2020-05-03,-141,Various Expenses,Alonit,7479
2020-05-03,-197,Cosmetics & Personal Care,Good Pharm,7282
2020-05-03,-138,Entertainments,Hot Movies,7144
2020-05-03,-110,Donations & Taxes,Paamonim,7034
2020-05-04,-30,Newspapers,Yediot Aharonot,7004
2020-05-04,-30,Various Expenses,Yellow,6974
2020-05-05,-588,Supermarket,Rami Levi,6386
2020-05-06,-195,Gas,Alon,6191
2020-05-06,-167,Entertainments,Escape Room,6024
2020-05-06,-150,Cellular,Partner,5874
2020-05-09,-177,Entertainments,Cinima City,5697
2020-05-10,-300,Saving,Exellence Investments,5397
2020-05-10,-515,Supermarket,Osher Ad,4882
2020-05-10,6000,Income,Social Security,10882
2020-05-10,6000,Income,Salary 2,16882
2020-05-11,-400,Cash withdrawals,ATM,16482
2020-05-11,-3450,Mortgage / Rent,Avi Kuperman,13032
2020-05-11,-505,Electricity,Electric Company,12527
2020-05-12,-197,"Pharmacy, Specialist Doctor",Be,12330
2020-05-13,-40,Restaurants,Falafel Shef,12290
2020-05-13,-190,Gas,Sonol,12100
2020-05-14,-400,Cash withdrawals,ATM,11700
2020-05-14,-186,Water,Ein Cramim,11514
2020-05-14,-41,Restaurants,Falafel Shef,11473
2020-05-15,-156,Restaurants,Dominos Pizza,11317
2020-05-15,-150,Restaurants,Japanica,11167
2020-05-16,-264,Furniture & Household Equipment,Golf & Co,10903
2020-05-16,-50,Supermarket,Tiv Taam,10853
2020-05-16,-62,Supermarket,Victory,10791
2020-05-17,-169,Various Expenses,Colbo Dani,10622
2020-05-19,-190,Gas,Alon,10432
2020-05-19,-65,Health Insurance / HMO,Clalit,10367
2020-05-19,-249,Health Insurance / HMO,Harel,10118
2020-05-20,-200,Cash withdrawals,ATM,9918
2020-05-20,-122,Various Expenses,Mifgash HaDerekh,9796
2020-05-21,-700,Property Tax,Carmiel Municipality,9096
2020-05-21,-58,Various Expenses,So Good,9038
2020-05-22,-622,Supermarket,Tiv Taam,8416
2020-05-24,-380,Car Insurance,AIG,8036
2020-05-24,-200,Cash withdrawals,ATM,7836
2020-05-26,-120,Education & Classes,Gym,7716
2020-05-26,-639,Education & Classes,Success - Private High-School,7077
2020-05-29,-89,Internet,Bezeq,6988
2020-05-30,-16,Public Transport,Kavim,6972
2020-06-01,-19,Bank Commissions,Bank Hapoalom,6953
2020-06-01,-33,Public Transport,Egged,6920
2020-06-01,-170,Restaurants,Vivino,6750
2020-06-02,-204,Gas,Delek,6546
2020-06-02,-180,Public Transport,Egged,6366
2020-06-02,-47,TV,Netflix,6319
2020-06-04,-30,Newspapers,Yediot Aharonot,6289
2020-06-05,-78,Supermarket,Shufersal,6211
2020-06-06,-200,Cash withdrawals,ATM,6011
2020-06-06,-150,Cellular,Partner,5861
2020-06-06,-122,Clothing,Tamnoon,5739
2020-06-07,-90,Various Expenses,Colbo Dani,5649
2020-06-07,-36,Restaurants,Shawarma Shemesh,5613
2020-06-08,-152,Restaurants,Greg Coffee,5461
2020-06-08,-110,Donations & Taxes,IRS,5351
2020-06-09,-45,Supermarket,Osher Ad,5306
2020-06-10,-300,Saving,Exellence Investments,5006
2020-06-10,5870,Income,A.D Services,10876
2020-06-10,6000,Income,Salary 2,16876
2020-06-11,-3450,Mortgage / Rent,Avi Kuperman,13426
2020-06-12,-167,Various Expenses,Alonit,13259
2020-06-12,-592,Supermarket,Victory,12667
2020-06-13,-188,Entertainments,Cinima City,12479
2020-06-15,-552,Supermarket,Shufersal,11927
2020-06-16,-66,Supermarket,Tiv Taam,11861
2020-06-17,-39,Public Transport,Nativ Express,11822
2020-06-19,-65,Health Insurance / HMO,Clalit,11757
2020-06-19,-249,Health Insurance / HMO,Harel,11508
2020-06-19,-119,Entertainments,Jimbori,11389
2020-06-19,-37,Public Transport,Nativ Express,11352
2020-06-23,-212,"Pharmacy, Specialist Doctor",Super-Pharm,11140
2020-06-24,-380,Car Insurance,AIG,10760
2020-06-25,-189,Gas,Delek,10571
2020-06-26,-120,Education & Classes,Gym,10451
2020-06-26,-649,Education & Classes,Success - Private High-School,9802
2020-06-27,-590,Supermarket,Osher Ad,9212
2020-06-29,-400,Cash withdrawals,ATM,8812
2020-06-29,-89,Internet,Bezeq,8723
2020-06-29,-200,Gas,Paz,8523
2020-06-30,-156,Entertainments,Cinima City,8367
2020-06-30,-142,Entertainments,Escape Room,8225
2020-07-01,-17,Bank Commissions,Bank Hapoalom,8208
2020-07-01,-100,Various Expenses,Kiosk Yossi,8108
2020-07-01,-530,Supermarket,Shufersal,7578
2020-07-01,-637,Supermarket,Shufersal,6941
2020-07-02,-180,Public Transport,Egged,6761
2020-07-02,-162,Restaurants,Greg Coffee,6599
2020-07-02,-47,TV,Netflix,6552
2020-07-03,-667,Supermarket,Osher Ad,5885
2020-07-03,-36,Supermarket,Victory,5849
2020-07-04,-30,Newspapers,Yediot Aharonot,5819
2020-07-06,-150,Cellular,Partner,5669
2020-07-09,-210,Gas,Delek,5459
2020-07-09,-99,Various Expenses,Kiosk Yossi,5360
2020-07-10,-400,Cash withdrawals,ATM,4960
2020-07-10,-645,Electricity,Electric Company,4315
2020-07-10,-300,Saving,Exellence Investments,4015
2020-07-10,-38,Public Transport,Kavim,3977
2020-07-10,6103,Income,A.D Services,10080
2020-07-10,6000,Income,Salary 2,16080
2020-07-11,-3450,Mortgage / Rent,Avi Kuperman,12630
2020-07-12,-188,Gas,Alon,12442
2020-07-12,-257,Water,Ein Cramim,12185
2020-07-12,-2250,Vacations,Rimonim,9935
2020-07-13,-36,Restaurants,Shawarma Shemesh,9899
2020-07-14,-195,Restaurants,Vivino,9704
2020-07-16,-40,Restaurants,Hummus Eliyahu,9664
2020-07-17,-203,"Pharmacy, Specialist Doctor",Good Pharm,9461
2020-07-18,-109,Entertainments,Jimbori,9352
2020-07-19,-65,Health Insurance / HMO,Clalit,9287
2020-07-19,-249,Health Insurance / HMO,Harel,9038
2020-07-19,-56,Supermarket,Tiv Taam,8982
2020-07-20,-72,Various Expenses,Alonit,8910
2020-07-20,-700,Property Tax,Carmiel Municipality,8210
2020-07-21,-588,Supermarket,Shufersal,7622
2020-07-23,-39,Supermarket,Osher Ad,7583
2020-07-24,-380,Car Insurance,AIG,7203
2020-07-25,-179,Entertainments,Hot Movies,7024
2020-07-26,-120,Education & Classes,Gym,6904
2020-07-26,-152,Restaurants,Japanica,6752
2020-07-26,-35,Various Expenses,So Good,6717
2020-07-26,-630,Education & Classes,Success - Private High-School,6087
2020-07-28,-190,Entertainments,Hot Movies,5897
2020-07-28,-118,Clothing,Tamnoon,5779
2020-07-29,-89,Internet,Bezeq,5690
2020-07-30,-200,Cash withdrawals,ATM,5490
2020-07-31,-400,Cash withdrawals,ATM,5090
2020-07-31,-199,Gas,Paz,4891
2020-08-01,-204,Gas,Alon,4687
2020-08-01,-12,Bank Commissions,Bank Hapoalom,4675
2020-08-01,-180,Public Transport,Egged,4495
2020-08-01,-239,Cosmetics & Personal Care,SACARA,4256
2020-08-02,-47,TV,Netflix,4209
2020-08-03,-98,Donations & Taxes,IRS,4111
2020-08-03,-35,Supermarket,Osher Ad,4076
2020-08-03,-646,Supermarket,Shufersal,3430
2020-08-04,-642,Supermarket,Tiv Taam,2788
2020-08-04,-30,Newspapers,Yediot Aharonot,2758
2020-08-06,-41,Restaurants,Falafel Shef,2717
2020-08-06,-150,Cellular,Partner,2567
2020-08-07,-206,Restaurants,Dominos Pizza,2361
2020-08-09,-129,Clothing,Renuar,2232
2020-08-09,-100,Various Expenses,So Good,2132
2020-08-10,-200,Cash withdrawals,ATM,1932
2020-08-10,-300,Saving,Exellence Investments,1632
2020-08-10,-22,Public Transport,Kavim,1610
2020-08-10,-44,Supermarket,Osher Ad,1566
2020-08-10,6348,Income,A.D Services,7914
2020-08-10,6000,Income,Salary 2,13914
2020-08-11,-3450,Mortgage / Rent,Avi Kuperman,10464
2020-08-12,-281,Cosmetics & Personal Care,Be,10183
2020-08-13,-209,Restaurants,BBB,9974
2020-08-13,-198,Gas,Delek,9776
2020-08-16,-292,Office Supplies,Kravitz,9484
2020-08-17,-201,Gas,Paz,9283
2020-08-18,-28,Public Transport,Egged,9255
2020-08-19,-65,Health Insurance / HMO,Clalit,9190
2020-08-19,-249,Health Insurance / HMO,Harel,8941
2020-08-20,-597,Supermarket,Rami Levi,8344
2020-08-20,-103,Entertainments,Yamit 2000,8241
2020-08-21,-1253,Furniture & Household Equipment,Home Center,6988
2020-08-21,-163,Various Expenses,Mifgash HaDerekh,6825
2020-08-22,-20,Public Transport,Egged,6805
2020-08-23,-205,"Pharmacy, Specialist Doctor",Good Pharm,6600
2020-08-24,-380,Car Insurance,AIG,6220
2020-08-24,-150,Restaurants,Japanica,6070
2020-08-25,-133,Entertainments,Hot Movies,5937
2020-08-26,-120,Education & Classes,Gym,5817
2020-08-26,-641,Education & Classes,Success - Private High-School,5176
2020-08-27,-161,Entertainments,Hot Movies,5015
2020-08-28,-200,Cash withdrawals,ATM,4815
2020-08-29,-89,Internet,Bezeq,4726
2020-08-29,-42,Restaurants,Hummus Eliyahu,4684
2020-08-29,-102,Entertainments,Yamit 2000,4582
2020-08-30,-400,Cash withdrawals,ATM,4182
2020-08-31,-660,Supermarket,Shufersal,3522
2020-09-01,-13,Bank Commissions,Bank Hapoalom,3509
2020-09-01,-159,"Pharmacy, Specialist Doctor",Be,3350
2020-09-01,-180,Public Transport,Egged,3170
2020-09-02,-202,Gas,Alon,2968
2020-09-02,-190,Restaurants,Greg Coffee,2778
2020-09-02,-139,Various Expenses,Kiosk Yossi,2639
2020-09-02,-47,TV,Netflix,2592
2020-09-04,-34,Public Transport,Nativ Express,2558
2020-09-04,-30,Newspapers,Yediot Aharonot,2528
2020-09-06,-150,Cellular,Partner,2378
2020-09-08,-298,Cosmetics & Personal Care,Super-Pharm,2080
2020-09-09,-39,Restaurants,Hummus Eliyahu,2041
2020-09-10,-245,Water,Ein Cramim,1796
2020-09-10,-928,Electricity,Electric Company,868
2020-09-10,-300,Saving,Exellence Investments,568
2020-09-10,6526,Income,A.D Services,7094
2020-09-10,6000,Income,Salary 2,13094
2020-09-11,-200,Cash withdrawals,ATM,12894
2020-09-11,-3450,Mortgage / Rent,Avi Kuperman,9444
2020-09-12,-229,"Pharmacy, Specialist Doctor",Super-Pharm,9215
2020-09-13,-400,Cash withdrawals,ATM,8815
2020-09-15,-78,Supermarket,Osher Ad,8737
2020-09-17,-92,Donations & Taxes,Pithon Lev,8645
2020-09-18,-196,Gas,Delek,8449
2020-09-18,-158,Restaurants,Dominos Pizza,8291
2020-09-19,-400,Cash withdrawals,ATM,7891
2020-09-19,-700,Property Tax,Carmiel Municipality,7191
2020-09-19,-65,Health Insurance / HMO,Clalit,7126
2020-09-19,-249,Health Insurance / HMO,Harel,6877
2020-09-20,-645,Supermarket,Osher Ad,6232
2020-09-21,-140,Entertainments,Hot Movies,6092
2020-09-22,-230,Office Supplies,Ofiice Depot,5862
2020-09-24,-380,Car Insurance,AIG,5482
2020-09-24,-60,Supermarket,Osher Ad,5422
2020-09-25,-202,Gas,Delek,5220
2020-09-25,-141,Entertainments,Escape Room,5079
2020-09-26,-22,Public Transport,Egged,5057
2020-09-26,-120,Education & Classes,Gym,4937
2020-09-26,-658,Education & Classes,Success - Private High-School,4279
2020-09-28,-110,Clothing,Crazy Line,4169
2020-09-29,-89,Internet,Bezeq,4080
2020-09-30,-45,Various Expenses,Alonit,4035
2020-09-30,-200,Cash withdrawals,ATM,3835
2020-09-30,-85,Various Expenses,Kiosk Yossi,3750
2020-09-30,-650,Supermarket,Rami Levi,3100
2020-09-30,-662,Supermarket,Rami Levi,2438
2020-10-01,-20,Bank Commissions,Bank Hapoalom,2418
2020-10-01,-478,Clothing,Fox,1940
2020-10-01,-40,Supermarket,Rami Levi,1900
2020-10-02,-261,Cosmetics & Personal Care,Be,1639
2020-10-02,-180,Public Transport,Egged,1459
2020-10-02,-148,Various Expenses,Kiosk Yossi,1311
2020-10-02,-47,TV,Netflix,1264
2020-10-03,-132,Various Expenses,So Good,1132
2020-10-04,-30,Newspapers,Yediot Aharonot,1102
2020-10-05,-200,Cash withdrawals,ATM,902
2020-10-06,-150,Cellular,Partner,752
2020-10-08,-187,"Pharmacy, Specialist Doctor",Be,565
2020-10-08,-768,Supermarket,Victory,-203
2020-10-09,-54,Supermarket,Shufersal,-257
2020-10-10,-300,Saving,Exellence Investments,-557
2020-10-10,-40,Public Transport,Kavim,-597
2020-10-10,-137,Clothing,Renuar,-734
2020-10-10,6487,Income,A.D Services,5753
2020-10-10,6000,Income,Salary 2,11753
2020-10-11,-3450,Mortgage / Rent,Avi Kuperman,8303
2020-10-12,-210,Restaurants,BBB,8093
2020-10-12,-189,Gas,Delek,7904
2020-10-12,-69,Various Expenses,Yellow,7835
2020-10-13,-201,Gas,Delek,7634
2020-10-13,-20,Public Transport,Kavim,7614
2020-10-14,-141,Entertainments,Escape Room,7473
2020-10-14,-812,Supermarket,Shufersal,6661
2020-10-17,-400,Cash withdrawals,ATM,6261
2020-10-19,-65,Health Insurance / HMO,Clalit,6196
2020-10-19,-249,Health Insurance / HMO,Harel,5947
2020-10-20,-58,Supermarket,Victory,5889
2020-10-21,-805,Supermarket,Osher Ad,5084
2020-10-22,-258,Furniture & Household Equipment,Home Center,4826
2020-10-24,-380,Car Insurance,AIG,4446
2020-10-24,-155,Various Expenses,So Good,4291
2020-10-25,-740,Supermarket,Osher Ad,3551
2020-10-26,-120,Education & Classes,Gym,3431
2020-10-26,-200,Gas,Sonol,3231
2020-10-26,-629,Education & Classes,Success - Private High-School,2602
2020-10-26,-279,Cosmetics & Personal Care,Super-Pharm,2323
2020-10-27,-200,Cash withdrawals,ATM,2123
2020-10-28,-182,Entertainments,Escape Room,1941
2020-10-28,-41,Restaurants,Hummus Eliyahu,1900
2020-10-28,-150,Various Expenses,Mifgash HaDerekh,1750
2020-10-29,-89,Internet,Bezeq,1661
2020-10-29,-179,Restaurants,Japanica,1482
2020-10-30,-167,Restaurants,BBB,1315
2020-10-31,-184,Entertainments,Cinima City,1131
2020-11-01,-13,Bank Commissions,Bank Hapoalom,1118
2020-11-01,-180,Public Transport,Egged,938
2020-11-02,-170,Clothing,Mango,768
2020-11-02,-130,Various Expenses,Mifgash HaDerekh,638
2020-11-02,-47,TV,Netflix,591
2020-11-03,-141,Entertainments,Cinima City,450
2020-11-04,-547,Supermarket,Victory,-97
2020-11-04,-30,Newspapers,Yediot Aharonot,-127
2020-11-05,-157,Entertainments,Cinima City,-284
2020-11-06,-100,Various Expenses,Alonit,-384
2020-11-06,-150,Cellular,Partner,-534
2020-11-08,-200,Cash withdrawals,ATM,-734
2020-11-08,-58,Supermarket,Osher Ad,-792
2020-11-10,-27,Public Transport,Egged,-819
2020-11-10,-300,Saving,Exellence Investments,-1119
2020-11-10,-201,Restaurants,Greg Coffee,-1320
2020-11-10,6671,Income,A.D Services,5351
2020-11-10,6000,Income,Salary 2,11351
2020-11-10,-620,Supermarket,Shufersal,10731
2020-11-11,-3450,Mortgage / Rent,Avi Kuperman,7281
2020-11-11,-439,Electricity,Electric Company,6842
2020-11-11,-72,Supermarket,Osher Ad,6770
2020-11-13,-185,"Pharmacy, Specialist Doctor",Be,6585
2020-11-13,-614,Supermarket,Tiv Taam,5971
2020-11-13,-132,Various Expenses,Yellow,5839
2020-11-14,-201,Water,Ein Cramim,5638
2020-11-14,-224,Cosmetics & Personal Care,SACARA,5414
2020-11-18,-400,Cash withdrawals,ATM,5014
2020-11-19,-65,Health Insurance / HMO,Clalit,4949
2020-11-19,-249,Health Insurance / HMO,Harel,4700
2020-11-20,-700,Property Tax,Carmiel Municipality,4000
2020-11-20,-40,Restaurants,Hummus Eliyahu,3960
2020-11-22,-191,Restaurants,Japanica,3769
2020-11-24,-380,Car Insurance,AIG,3389
2020-11-24,-167,"Pharmacy, Specialist Doctor",Good Pharm,3222
2020-11-24,-163,Entertainments,Hot Movies,3059
2020-11-24,-192,Gas,Paz,2867
2020-11-24,-193,Gas,Paz,2674
2020-11-25,-174,Restaurants,Japanica,2500
2020-11-26,-120,Education & Classes,Gym,2380
2020-11-26,-635,Education & Classes,Success - Private High-School,1745
2020-11-26,-49,Supermarket,Victory,1696
2020-11-27,-210,Gas,Alon,1486
2020-11-27,-242,Cosmetics & Personal Care,Good Pharm,1244
2020-11-28,-28,Public Transport,Egged,1216
2020-11-29,-89,Internet,Bezeq,1127
2020-11-30,-609,Supermarket,Shufersal,518
2020-12-01,-200,Cash withdrawals,ATM,318
2020-12-01,-19,Bank Commissions,Bank Hapoalom,299
2020-12-01,-180,Public Transport,Egged,119
2020-12-01,-153,Various Expenses,So Good,-34
2020-12-01,-67,Supermarket,Tiv Taam,-101
2020-12-02,-200,Gas,Delek,-301
2020-12-02,-47,TV,Netflix,-348
2020-12-02,-53,Supermarket,Shufersal,-401
2020-12-02,-205,Gas,Sonol,-606
2020-12-04,-30,Newspapers,Yediot Aharonot,-636
2020-12-06,-150,Cellular,Partner,-786
2020-12-07,-46,Supermarket,Victory,-832
2020-12-10,-400,Cash withdrawals,ATM,-1232
2020-12-10,-300,Saving,Exellence Investments,-1532
2020-12-10,6670,Income,A.D Services,5138
2020-12-10,6000,Income,Salary 2,11138
2020-12-11,-3450,Mortgage / Rent,Avi Kuperman,7688
2020-12-11,-150,Various Expenses,Colbo Dani,7538
2020-12-13,-188,"Pharmacy, Specialist Doctor",Be,7350
2020-12-13,-209,Restaurants,Greg Coffee,7141
2020-12-15,-647,Supermarket,Osher Ad,6494
2020-12-16,-183,Entertainments,Hot Movies,6311
2020-12-17,-84,Various Expenses,Alonit,6227
2020-12-17,-646,Supermarket,Victory,5581
2020-12-19,-146,Various Expenses,Alonit,5435
2020-12-19,-65,Health Insurance / HMO,Clalit,5370
2020-12-19,-249,Health Insurance / HMO,Harel,5121
2020-12-21,-153,Entertainments,Escape Room,4968
2020-12-21,-161,"Pharmacy, Specialist Doctor",Good Pharm,4807
2020-12-22,-29,Public Transport,Egged,4778
2020-12-22,-180,Entertainments,Escape Room,4598
2020-12-22,-44,Various Expenses,Mifgash HaDerekh,4554
2020-12-24,-380,Car Insurance,AIG,4174
2020-12-24,-39,Restaurants,Hummus Eliyahu,4135
2020-12-24,-210,Gas,Paz,3925
2020-12-24,-637,Supermarket,Tiv Taam,3288
2020-12-26,-120,Education & Classes,Gym,3168
2020-12-26,-641,Education & Classes,Success - Private High-School,2527
2020-12-27,-106,Clothing,Tamnoon,2421
2020-12-28,-200,Cash withdrawals,ATM,2221
2020-12-28,-166,Office Supplies,Kravitz,2055
2020-12-29,-89,Internet,Bezeq,1966
2020-12-29,-162,Cosmetics & Personal Care,SACARA,1804
2020-12-30,-167,Restaurants,BBB,1637
2020-12-30,-151,Restaurants,BBB,1486
2021-01-01,-20,Bank Commissions,Bank Hapoalom,1466
2021-01-02,-165,Restaurants,BBB,1301
2021-01-02,-47,TV,Netflix,1254
2021-01-03,-154,Restaurants,Dominos Pizza,1100
2021-01-03,-180,Public Transport,Egged,920
2021-01-04,-30,Newspapers,Yediot Aharonot,890
2021-01-05,-65,Various Expenses,Alonit,825
2021-01-05,-400,Cash withdrawals,ATM,425
2021-01-06,-180,Restaurants,Japanica,245
2021-01-06,-150,Cellular,Partner,95
2021-01-07,-633,Supermarket,Osher Ad,-538
2021-01-08,-199,Gas,Delek,-737
2021-01-09,-19,Public Transport,Egged,-756
2021-01-09,-184,Water,Ein Cramim,-940
2021-01-09,-594,Electricity,Electric Company,-1534
2021-01-09,-72,Various Expenses,Kiosk Yossi,-1606
2021-01-09,-95,Donations & Taxes,Paamonim,-1701
2021-01-10,-300,Saving,Exellence Investments,-2001
2021-01-10,6920,Income,A.D Services,4919
2021-01-10,6000,Income,Salary 2,10919
2021-01-11,-3450,Mortgage / Rent,Avi Kuperman,7469
2021-01-12,-148,Entertainments,Cinima City,7321
2021-01-12,-99,Donations & Taxes,IRS,7222
2021-01-13,-40,Supermarket,Osher Ad,7182
2021-01-13,-120,Clothing,Renuar,7062
2021-01-14,-80,Various Expenses,Colbo Dani,6982
2021-01-17,-200,Cash withdrawals,ATM,6782
2021-01-17,-775,Property Tax,Carmiel Municipality,6007
2021-01-17,-40,Restaurants,Shawarma Shemesh,5967
2021-01-18,-668,Supermarket,Rami Levi,5299
2021-01-19,-161,Entertainments,Cinima City,5138
2021-01-19,-65,Health Insurance / HMO,Clalit,5073
2021-01-19,-249,Health Insurance / HMO,Harel,4824
2021-01-19,-593,Supermarket,Shufersal,4231
2021-01-20,-32,Various Expenses,Alonit,4199
2021-01-20,-143,Entertainments,Hot Movies,4056
2021-01-22,-199,Gas,Sonol,3857
2021-01-24,-380,Car Insurance,AIG,3477
2021-01-24,-190,Gas,Delek,3287
2021-01-24,-35,Supermarket,Rami Levi,3252
2021-01-25,-400,Cash withdrawals,ATM,2852
2021-01-25,-561,Supermarket,Victory,2291
2021-01-26,-1685,Vacations,Bereshit,606
2021-01-26,-120,Education & Classes,Gym,486
2021-01-26,-646,Education & Classes,Success - Private High-School,-160
2021-01-27,-54,Various Expenses,So Good,-214
2021-01-29,-89,Internet,Bezeq,-303
2021-01-30,-176,"Pharmacy, Specialist Doctor",Good Pharm,-479
2021-01-30,-37,Supermarket,Tiv Taam,-516
2021-02-01,-200,Cash withdrawals,ATM,-716
2021-02-01,-17,Bank Commissions,Bank Hapoalom,-733
2021-02-01,-180,Public Transport,Egged,-913
2021-02-02,-47,TV,Netflix,-960
2021-02-04,-30,Newspapers,Yediot Aharonot,-990
2021-02-05,-223,"Pharmacy, Specialist Doctor",Good Pharm,-1213
2021-02-06,-1009,Car Maintenance,Garage Carmiel,-2222
2021-02-06,-37,Restaurants,Hummus Eliyahu,-2259
2021-02-06,-150,Cellular,Partner,-2409
2021-02-07,-624,Supermarket,Tiv Taam,-3033
2021-02-09,-186.85,Gas,Paz,-3219.85
2021-02-10,-300,Saving,Exellence Investments,-3519.85
2021-02-10,7000,Income,A.D Services,3480.15
2021-02-10,6000,Income,Salary 2,9480.15
2021-02-11,-3450,Mortgage / Rent,Avi Kuperman,6030.15
2021-02-12,-74,Various Expenses,Colbo Dani,5956.15
2021-02-12,-169,Restaurants,Japanica,5787.15
2021-02-12,-502,Supermarket,Rami Levi,5285.15
2021-02-14,-183,Restaurants,Greg Coffee,5102.15
2021-02-14,-37,Public Transport,Nativ Express,5065.15
2021-02-15,-553,Supermarket,Rami Levi,4512.15
2021-02-19,-65,Health Insurance / HMO,Clalit,4447.15
2021-02-19,-249,Health Insurance / HMO,Harel,4198.15
2021-02-20,-627,Supermarket,Shufersal,3571.15
2021-02-20,-41,Supermarket,Victory,3530.15
2021-02-21,-210,Cosmetics & Personal Care,SACARA,3320.15
2021-02-22,-41,Restaurants,Falafel Shef,3279.15
2021-02-22,-122,Various Expenses,So Good,3157.15
2021-02-24,-380,Car Insurance,AIG,2777.15
2021-02-24,-154,Entertainments,Escape Room,2623.15
2021-02-25,-212,Cosmetics & Personal Care,Be,2411.15
2021-02-26,-180,Entertainments,Cinima City,2231.15
2021-02-26,-120,Education & Classes,Gym,2111.15
2021-02-26,-670,Education & Classes,Success - Private High-School,1441.15
2021-02-27,-112,Clothing,Mango,1329.15
2021-02-28,-400,Cash withdrawals,ATM,929.15
2021-02-28,-89,Internet,Bezeq,840.15
2021-02-28,-189.88,Gas,Delek,650.27
2021-02-28,-90,Donations & Taxes,IRS,560.27
2021-02-28,-197.96,Gas,Paz,362.31
2021-02-28,-76,Supermarket,Shufersal,286.31
2021-03-01,-17,Bank Commissions,Bank Hapoalom,269.31
2021-03-02,-180,Public Transport,Egged,89.31
2021-03-02,-47,TV,Netflix,42.31
2021-03-02,-33,Supermarket,Rami Levi,9.31
2021-03-03,-165,"Pharmacy, Specialist Doctor",Good Pharm,-155.69
2021-03-03,-1309,Furniture & Household Equipment,Home Center,-1464.69
2021-03-03,-626,Supermarket,Shufersal,-2090.69
2021-03-04,-36,Restaurants,Hummus Eliyahu,-2126.69
2021-03-04,-30,Newspapers,Yediot Aharonot,-2156.69
2021-03-05,-133,Entertainments,Cinima City,-2289.69
2021-03-06,-150,Cellular,Partner,-2439.69
2021-03-06,-158,Various Expenses,So Good,-2597.69
2021-03-07,-200,Cash withdrawals,ATM,-2797.69
2021-03-07,-151,Clothing,Crazy Line,-2948.69
2021-03-07,-197.88,Gas,Sonol,-3146.57
2021-03-08,-400,Cash withdrawals,ATM,-3546.57
2021-03-08,-169,Entertainments,Cinima City,-3715.57
2021-03-08,-15,Public Transport,Egged,-3730.57
2021-03-08,-45,Various Expenses,So Good,-3775.57
2021-03-09,-214.2,Gas,Delek,-3989.77
2021-03-09,-208,Water,Ein Cramim,-4197.77
2021-03-10,-166,Restaurants,Dominos Pizza,-4363.77
2021-03-10,-300,Saving,Exellence Investments,-4663.77
2021-03-10,7151,Income,A.D Services,2487.23
2021-03-10,6000,Income,Salary 2,8487.23
2021-03-11,-3450,Mortgage / Rent,Avi Kuperman,5037.23
2021-03-11,-915,Electricity,Electric Company,4122.23
2021-03-11,-90,Various Expenses,Mifgash HaDerekh,4032.23
2021-03-11,-66,Supermarket,Osher Ad,3966.23
2021-03-16,-159,Entertainments,Cinima City,3807.23
2021-03-18,-775,Property Tax,Carmiel Municipality,3032.23
2021-03-19,-65,Health Insurance / HMO,Clalit,2967.23
2021-03-19,-249,Health Insurance / HMO,Harel,2718.23
2021-03-19,-29,Public Transport,Kavim,2689.23
2021-03-19,-130,Various Expenses,Mifgash HaDerekh,2559.23
2021-03-21,-210.12,Gas,Paz,2349.11
2021-03-22,-52,Various Expenses,Colbo Dani,2297.11
2021-03-22,-548,Supermarket,Rami Levi,1749.11
2021-03-24,-380,Car Insurance,AIG,1369.11
2021-03-25,-200,Cash withdrawals,ATM,1169.11
2021-03-26,-156,Cosmetics & Personal Care,Be,1013.11
2021-03-26,-120,Education & Classes,Gym,893.11
2021-03-26,-656,Education & Classes,Success - Private High-School,237.11
2021-03-26,-612,Supermarket,Tiv Taam,-374.89
2021-03-28,-38,Supermarket,Victory,-412.89
2021-03-29,-89,Internet,Bezeq,-501.89
2021-03-29,-595,Supermarket,Tiv Taam,-1096.89
2021-03-30,-208,Restaurants,Dominos Pizza,-1304.89
2021-04-01,-19,Bank Commissions,Bank Hapoalom,-1323.89
2021-04-01,-180,Public Transport,Egged,-1503.89
2021-04-01,-34,Supermarket,Shufersal,-1537.89
2021-04-02,-47,TV,Netflix,-1584.89
2021-04-04,-30,Newspapers,Yediot Aharonot,-1614.89
2021-04-05,-400,Cash withdrawals,ATM,-2014.89
2021-04-06,-150,Cellular,Partner,-2164.89
2021-04-07,-182,Restaurants,BBB,-2346.89
2021-04-07,-163,Cosmetics & Personal Care,Good Pharm,-2509.89
2021-04-07,-158,Entertainments,Hot Movies,-2667.89
2021-04-10,-300,Saving,Exellence Investments,-2967.89
2021-04-10,7238,Income,A.D Services,4270.11
2021-04-10,6000,Income,Salary 2,10270.11
2021-04-11,-3450,Mortgage / Rent,Avi Kuperman,6820.11
2021-04-11,-734,Supermarket,Rami Levi,6086.11
2021-04-11,-486,Clothing,Tamnoon,5600.11
2021-04-11,-724,Supermarket,Victory,4876.11
2021-04-12,-200,Cash withdrawals,ATM,4676.11
2021-04-12,-229,"Pharmacy, Specialist Doctor",Super-Pharm,4447.11
2021-04-13,-146,Various Expenses,Alonit,4301.11
2021-04-15,-55,Various Expenses,Colbo Dani,4246.11
2021-04-16,-158,Various Expenses,Colbo Dani,4088.11
2021-04-16,-175,Various Expenses,Colbo Dani,3913.11
2021-04-16,-127,Clothing,Crazy Line,3786.11
2021-04-17,-200,Cash withdrawals,ATM,3586.11
2021-04-17,-152,"Pharmacy, Specialist Doctor",Good Pharm,3434.11
2021-04-17,-168,Restaurants,Greg Coffee,3266.11
2021-04-18,-66,Supermarket,Tiv Taam,3200.11
2021-04-19,-153,Entertainments,Cinima City,3047.11
2021-04-19,-65,Health Insurance / HMO,Clalit,2982.11
2021-04-19,-249,Health Insurance / HMO,Harel,2733.11
2021-04-19,-198.79,Gas,Paz,2534.32
2021-04-20,-197,Restaurants,Japanica,2337.32
2021-04-22,-189,Cosmetics & Personal Care,Good Pharm,2148.32
2021-04-22,-805,Supermarket,Rami Levi,1343.32
2021-04-23,-112,Various Expenses,Colbo Dani,1231.32
2021-04-23,-104,Donations & Taxes,IRS,1127.32
2021-04-24,-380,Car Insurance,AIG,747.32
2021-04-24,-35,Restaurants,Falafel Shef,712.32
2021-04-25,-197.76,Gas,Paz,514.56
2021-04-26,-120,Education & Classes,Gym,394.56
2021-04-26,-40,Restaurants,Hummus Eliyahu,354.56
2021-04-26,-654,Education & Classes,Success - Private High-School,-299.44
2021-04-28,-42,Public Transport,Kavim,-341.44
2021-04-29,-89,Internet,Bezeq,-430.44
2021-04-29,-33,Supermarket,Shufersal,-463.44
2021-04-30,-209.09,Gas,Alon,-672.53
2021-05-01,-17,Bank Commissions,Bank Hapoalom,-689.53
2021-05-01,-140,Entertainments,Cinima City,-829.53
2021-05-02,-123,Clothing,Fox,-952.53
2021-05-02,-47,TV,Netflix,-999.53
2021-05-03,-180,Public Transport,Egged,-1179.53
2021-05-04,-30,Newspapers,Yediot Aharonot,-1209.53
2021-05-05,-183,Restaurants,Greg Coffee,-1392.53
2021-05-06,-150,Cellular,Partner,-1542.53
2021-05-09,-491,Electricity,Electric Company,-2033.53
2021-05-09,-19,Public Transport,Kavim,-2052.53
2021-05-10,-165,"Pharmacy, Specialist Doctor",Be,-2217.53
2021-05-10,-300,Saving,Exellence Investments,-2517.53
2021-05-10,-167,Cosmetics & Personal Care,SACARA,-2684.53
2021-05-10,7106,Income,A.D Services,4421.47
2021-05-10,6000,Income,Salary 2,10421.47
2021-05-11,-3450,Mortgage / Rent,Avi Kuperman,6971.47
2021-05-11,-182,Restaurants,Japanica,6789.47
2021-05-12,-136,Entertainments,Cinima City,6653.47
2021-05-12,-206.96,Gas,Delek,6446.51
2021-05-12,-508,Supermarket,Tiv Taam,5938.51
2021-05-13,-250,"Pharmacy, Specialist Doctor",Be,5688.51
2021-05-14,-141,Various Expenses,Colbo Dani,5547.51
2021-05-14,-193,Water,Ein Cramim,5354.51
2021-05-18,-775,Property Tax,Carmiel Municipality,4579.51
2021-05-18,-637,Supermarket,Osher Ad,3942.51
2021-05-19,-65,Health Insurance / HMO,Clalit,3877.51
2021-05-19,-249,Health Insurance / HMO,Harel,3628.51
2021-05-19,-164,Various Expenses,Mifgash HaDerekh,3464.51
2021-05-19,-70,Supermarket,Victory,3394.51
2021-05-20,-110,Various Expenses,Kiosk Yossi,3284.51
2021-05-20,-208,Gas,Paz,3076.51
2021-05-21,-200,Cash withdrawals,ATM,2876.51
2021-05-23,-15,Public Transport,Egged,2861.51
2021-05-23,-549,Supermarket,Tiv Taam,2312.51
2021-05-24,-380,Car Insurance,AIG,1932.51
2021-05-24,-205.92,Gas,Alon,1726.59
2021-05-24,-180,Entertainments,Escape Room,1546.59
2021-05-25,-54,Supermarket,Tiv Taam,1492.59
2021-05-26,-120,Education & Classes,Gym,1372.59
2021-05-26,-46,Supermarket,Shufersal,1326.59
2021-05-26,-654,Education & Classes,Success - Private High-School,672.59
2021-05-27,-39,Restaurants,Hummus Eliyahu,633.59
2021-05-29,-89,Internet,Bezeq,544.59
2021-05-30,-244,Furniture & Household Equipment,Fox Home,300.59
2021-05-31,-400,Cash withdrawals,ATM,-99.41
2021-05-31,-552,Supermarket,Shufersal,-651.41
2021-06-01,-13,Bank Commissions,Bank Hapoalom,-664.41
2021-06-02,-47,TV,Netflix,-711.41
2021-06-03,-180,Public Transport,Egged,-891.41
2021-06-03,-548,Supermarket,Shufersal,-1439.41
2021-06-04,-30,Newspapers,Yediot Aharonot,-1469.41
2021-06-05,-54,Various Expenses,Colbo Dani,-1523.41
2021-06-06,-173,Entertainments,Cinima City,-1696.41
2021-06-06,-150,Cellular,Partner,-1846.41
2021-06-07,-187,Restaurants,BBB,-2033.41
2021-06-07,-228,Cosmetics & Personal Care,Super-Pharm,-2261.41
2021-06-07,-100,Various Expenses,Yellow,-2361.41
2021-06-10,-300,Saving,Exellence Investments,-2661.41
2021-06-10,7464,Income,A.D Services,4802.59
2021-06-10,6000,Income,Salary 2,10802.59
2021-06-11,-3450,Mortgage / Rent,Avi Kuperman,7352.59
2021-06-11,-577,Supermarket,Osher Ad,6775.59
2021-06-12,-131,Various Expenses,Yellow,6644.59
2021-06-13,-32,Public Transport,Kavim,6612.59
2021-06-13,-133,Clothing,Renuar,6479.59
2021-06-14,-159,Various Expenses,Alonit,6320.59
2021-06-14,-82,Entertainments,Yamit 2000,6238.59
2021-06-15,-552,Supermarket,Osher Ad,5686.59
2021-06-16,-216.3,Gas,Paz,5470.29
2021-06-18,-207.9,Gas,Delek,5262.39
2021-06-19,-65,Health Insurance / HMO,Clalit,5197.39
2021-06-19,-41,Restaurants,Falafel Shef,5156.39
2021-06-19,-249,Health Insurance / HMO,Harel,4907.39
2021-06-20,-400,Cash withdrawals,ATM,4507.39
2021-06-21,-200,Cash withdrawals,ATM,4307.39
2021-06-22,-197.4,Gas,Alon,4109.99
2021-06-23,-188,"Pharmacy, Specialist Doctor",Be,3921.99
2021-06-24,-380,Car Insurance,AIG,3541.99
2021-06-24,-290,Cosmetics & Personal Care,Super-Pharm,3251.99
2021-06-25,-200,Cash withdrawals,ATM,3051.99
2021-06-25,-400,Cash withdrawals,ATM,2651.99
2021-06-25,-148,Entertainments,Hot Movies,2503.99
2021-06-25,-68,Supermarket,Victory,2435.99
2021-06-26,-120,Education & Classes,Gym,2315.99
2021-06-26,-656,Education & Classes,Success - Private High-School,1659.99
2021-06-28,-87,Entertainments,I-Jump,1572.99
2021-06-28,-194,Restaurants,Vivino,1378.99
2021-06-29,-89,Internet,Bezeq,1289.99
2021-06-30,-73,Supermarket,Rami Levi,1216.99
2021-07-01,-20,Bank Commissions,Bank Hapoalom,1196.99
2021-07-02,-400,Cash withdrawals,ATM,796.99
2021-07-02,-166,Restaurants,Japanica,630.99
2021-07-02,-16,Public Transport,Kavim,614.99
2021-07-02,-47,TV,Netflix,567.99
2021-07-02,-660,Supermarket,Victory,-92.01
2021-07-03,-180,Public Transport,Egged,-272.01
2021-07-03,-42,Restaurants,Falafel Shef,-314.01
2021-07-04,-30,Newspapers,Yediot Aharonot,-344.01
2021-07-06,-161,Entertainments,Hot Movies,-505.01
2021-07-06,-150,Cellular,Partner,-655.01
2021-07-07,-210.94,Gas,Alon,-865.95
2021-07-07,-216.24,Gas,Delek,-1082.19
2021-07-08,-632,Electricity,Electric Company,-1714.19
2021-07-08,-38,Supermarket,Tiv Taam,-1752.19
2021-07-09,-114,Various Expenses,Colbo Dani,-1866.19
2021-07-09,-49,Supermarket,Shufersal,-1915.19
2021-07-09,-95,Entertainments,Yamit 2000,-2010.19
2021-07-09,-84,Various Expenses,Yellow,-2094.19
2021-07-10,-300,Saving,Exellence Investments,-2394.19
2021-07-10,7552,Income,A.D Services,5157.81
2021-07-10,6000,Income,Salary 2,11157.81
2021-07-10,-107,Clothing,Tamnoon,11050.81
2021-07-11,-3450,Mortgage / Rent,Avi Kuperman,7600.81
2021-07-11,-259,Water,Ein Cramim,7341.81
2021-07-11,-87,Various Expenses,Mifgash HaDerekh,7254.81
2021-07-12,-263,Cosmetics & Personal Care,Be,6991.81
2021-07-12,-535,Supermarket,Rami Levi,6456.81
2021-07-13,-99,Entertainments,I-Jump,6357.81
2021-07-13,-99,Donations & Taxes,Latet,6258.81
2021-07-14,-198,"Pharmacy, Specialist Doctor",Super-Pharm,6060.81
2021-07-17,-200,Cash withdrawals,ATM,5860.81
2021-07-17,-775,Property Tax,Carmiel Municipality,5085.81
2021-07-18,-63,Supermarket,Tiv Taam,5022.81
2021-07-19,-65,Health Insurance / HMO,Clalit,4957.81
2021-07-19,-249,Health Insurance / HMO,Harel,4708.81
2021-07-19,-201,"Pharmacy, Specialist Doctor",Super-Pharm,4507.81
2021-07-22,-258,Cosmetics & Personal Care,Good Pharm,4249.81
2021-07-23,-581,Supermarket,Shufersal,3668.81
2021-07-24,-380,Car Insurance,AIG,3288.81
2021-07-24,-400,Cash withdrawals,ATM,2888.81
2021-07-24,-186,Entertainments,Cinima City,2702.81
2021-07-25,-55,Various Expenses,Alonit,2647.81
2021-07-26,-120,Education & Classes,Gym,2527.81
2021-07-26,-646,Education & Classes,Success - Private High-School,1881.81
2021-07-27,-187,Restaurants,Japanica,1694.81
2021-07-29,-89,Internet,Bezeq,1605.81
2021-07-29,-533,Supermarket,Rami Levi,1072.81
2021-07-30,-26,Public Transport,Egged,1046.81
2021-07-31,-200.34,Gas,Alon,846.47
2021-07-31,-2314,Vacations,Bereshit,-1467.53
2021-08-01,-16,Bank Commissions,Bank Hapoalom,-1483.53
2021-08-02,-47,TV,Netflix,-1530.53
2021-08-03,-180,Public Transport,Egged,-1710.53
2021-08-04,-195,Restaurants,Greg Coffee,-1905.53
2021-08-04,-150,Clothing,Tamnoon,-2055.53
2021-08-04,-30,Newspapers,Yediot Aharonot,-2085.53
2021-08-05,-180,Restaurants,Dominos Pizza,-2265.53
2021-08-06,-205,"Pharmacy, Specialist Doctor",Be,-2470.53
2021-08-06,-150,Cellular,Partner,-2620.53
2021-08-07,-243,Office Supplies,Kravitz,-2863.53
2021-08-10,-300,Saving,Exellence Investments,-3163.53
2021-08-10,7721,Income,A.D Services,4557.47
2021-08-10,6000,Income,Salary 2,10557.47
2021-08-10,-531,Supermarket,Tiv Taam,10026.47
2021-08-11,-3450,Mortgage / Rent,Avi Kuperman,6576.47
2021-08-13,-37,Supermarket,Rami Levi,6539.47
2021-08-14,-182,"Pharmacy, Specialist Doctor",Good Pharm,6357.47
2021-08-15,-42,Public Transport,Nativ Express,6315.47
2021-08-17,-207.58,Gas,Alon,6107.89
2021-08-18,-400,Cash withdrawals,ATM,5707.89
2021-08-18,-206,Restaurants,Vivino,5501.89
2021-08-19,-65,Health Insurance / HMO,Clalit,5436.89
2021-08-19,-249,Health Insurance / HMO,Harel,5187.89
2021-08-20,-661,Supermarket,Tiv Taam,4526.89
2021-08-21,-172,Entertainments,Cinima City,4354.89
2021-08-21,-145,Various Expenses,Colbo Dani,4209.89
2021-08-22,-400,Cash withdrawals,ATM,3809.89
2021-08-22,-1258,Furniture & Household Equipment,Fox Home,2551.89
2021-08-23,-42,Restaurants,Falafel Shef,2509.89
2021-08-23,-42,Various Expenses,So Good,2467.89
2021-08-24,-380,Car Insurance,AIG,2087.89
2021-08-24,-200,Cash withdrawals,ATM,1887.89
2021-08-26,-15,Public Transport,Egged,1872.89
2021-08-26,-120,Education & Classes,Gym,1752.89
2021-08-26,-638,Education & Classes,Success - Private High-School,1114.89
2021-08-27,-265,Cosmetics & Personal Care,Super-Pharm,849.89
2021-08-28,-557,Supermarket,Victory,292.89
2021-08-29,-89,Internet,Bezeq,203.89
2021-08-29,-221.49,Gas,Delek,-17.6
2021-08-29,-90,Entertainments,Jimbori,-107.6
2021-08-29,-77,Donations & Taxes,Latet,-184.6
2021-08-29,-57,Supermarket,Tiv Taam,-241.6
2021-08-31,-133,Entertainments,Cinima City,-374.6
2021-08-31,-224.7,Gas,Sonol,-599.3
2021-09-01,-19,Bank Commissions,Bank Hapoalom,-618.3
2021-09-01,-115,Clothing,Renuar,-733.3
2021-09-02,-47,TV,Netflix,-780.3
2021-09-03,-214,"Pharmacy, Specialist Doctor",Be,-994.3
2021-09-03,-180,Public Transport,Egged,-1174.3
2021-09-04,-560,Supermarket,Tiv Taam,-1734.3
2021-09-04,-30,Newspapers,Yediot Aharonot,-1764.3
2021-09-05,-52,Supermarket,Victory,-1816.3
2021-09-06,-150,Cellular,Partner,-1966.3
2021-09-06,-226,Cosmetics & Personal Care,SACARA,-2192.3
2021-09-07,-201.96,Gas,Sonol,-2394.26
2021-09-07,-508,Supermarket,Victory,-2902.26
2021-09-08,-400,Cash withdrawals,ATM,-3302.26
2021-09-09,-245,Water,Ein Cramim,-3547.26
2021-09-09,-290,Cosmetics & Personal Care,Good Pharm,-3837.26
2021-09-10,-223.56,Gas,Delek,-4060.82
2021-09-10,-920,Electricity,Electric Company,-4980.82
2021-09-10,-300,Saving,Exellence Investments,-5280.82
2021-09-10,7890,Income,A.D Services,2609.18
2021-09-10,6000,Income,Salary 2,8609.18
2021-09-11,-3450,Mortgage / Rent,Avi Kuperman,5159.18
2021-09-12,-178,Entertainments,Cinima City,4981.18
2021-09-15,-210,Restaurants,Greg Coffee,4771.18
2021-09-18,-211.68,Gas,Alon,4559.5
2021-09-18,-211,"Pharmacy, Specialist Doctor",Good Pharm,4348.5
2021-09-18,-149,Entertainments,Hot Movies,4199.5
2021-09-18,-117,Various Expenses,Mifgash HaDerekh,4082.5
2021-09-19,-65,Health Insurance / HMO,Clalit,4017.5
2021-09-19,-165,Entertainments,Escape Room,3852.5
2021-09-19,-249,Health Insurance / HMO,Harel,3603.5
2021-09-19,-41,Supermarket,Shufersal,3562.5
2021-09-19,-657,Supermarket,Victory,2905.5
2021-09-20,-775,Property Tax,Carmiel Municipality,2130.5
2021-09-20,-281,Office Supplies,Kravitz,1849.5
2021-09-21,-167,Restaurants,Japanica,1682.5
2021-09-23,-200,Cash withdrawals,ATM,1482.5
2021-09-24,-380,Car Insurance,AIG,1102.5
2021-09-24,-42,Various Expenses,Yellow,1060.5
2021-09-26,-120,Education & Classes,Gym,940.5
2021-09-26,-636,Education & Classes,Success - Private High-School,304.5
2021-09-27,-200,Cash withdrawals,ATM,104.5
2021-09-27,-88,Donations & Taxes,Latet,16.5
2021-09-27,-559,Supermarket,Shufersal,-542.5
2021-09-29,-89,Internet,Bezeq,-631.5
2021-09-29,-40,Restaurants,Hummus Eliyahu,-671.5
2021-09-30,-40,Public Transport,Nativ Express,-711.5
2021-10-01,-16,Bank Commissions,Bank Hapoalom,-727.5
2021-10-01,-41,Restaurants,Falafel Shef,-768.5
2021-10-01,-80,Supermarket,Victory,-848.5
2021-10-02,-195,Restaurants,Greg Coffee,-1043.5
2021-10-02,-47,TV,Netflix,-1090.5
2021-10-03,-180,Public Transport,Egged,-1270.5
2021-10-04,-30,Newspapers,Yediot Aharonot,-1300.5
2021-10-06,-150,Cellular,Partner,-1450.5
2021-10-06,-71,Supermarket,Rami Levi,-1521.5
2021-10-06,-831,Supermarket,Tiv Taam,-2352.5
2021-10-08,-18,Public Transport,Egged,-2370.5
2021-10-08,-723,Supermarket,Osher Ad,-3093.5
2021-10-10,-300,Saving,Exellence Investments,-3393.5
2021-10-10,8074,Income,A.D Services,4680.5
2021-10-10,6000,Income,Salary 2,10680.5
2021-10-11,-3450,Mortgage / Rent,Avi Kuperman,7230.5
2021-10-11,-159,Various Expenses,Kiosk Yossi,7071.5
2021-10-12,-190,Entertainments,Hot Movies,6881.5
2021-10-12,-151,Clothing,Tamnoon,6730.5
2021-10-13,-146,Entertainments,Hot Movies,6584.5
2021-10-14,-126,Various Expenses,Colbo Dani,6458.5
2021-10-15,-99,Various Expenses,Mifgash HaDerekh,6359.5
2021-10-16,-169,Restaurants,BBB,6190.5
2021-10-18,-400,Cash withdrawals,ATM,5790.5
2021-10-19,-65,Health Insurance / HMO,Clalit,5725.5
2021-10-19,-249,Health Insurance / HMO,Harel,5476.5
2021-10-19,-774,Supermarket,Osher Ad,4702.5
2021-10-19,-214.73,Gas,Paz,4487.77
2021-10-21,-802,Supermarket,Osher Ad,3685.77
2021-10-23,-35,Public Transport,Kavim,3650.77
2021-10-24,-380,Car Insurance,AIG,3270.77
2021-10-25,-274,Furniture & Household Equipment,Ace,2996.77
2021-10-25,-239,"Pharmacy, Specialist Doctor",Be,2757.77
2021-10-25,-274,Cosmetics & Personal Care,Good Pharm,2483.77
2021-10-26,-200,Cash withdrawals,ATM,2283.77
2021-10-26,-120,Education & Classes,Gym,2163.77
2021-10-26,-629,Education & Classes,Success - Private High-School,1534.77
2021-10-27,-227.81,Gas,Paz,1306.96
2021-10-28,-219.09,Gas,Paz,1087.87
2021-10-29,-89,Internet,Bezeq,998.87
2021-10-31,-339,Clothing,Crazy Line,659.87
2021-11-01,-16,Bank Commissions,Bank Hapoalom,643.87
2021-11-01,-155,"Pharmacy, Specialist Doctor",Good Pharm,488.87
2021-11-02,-180,Public Transport,Egged,308.87
2021-11-02,-47,TV,Netflix,261.87
2021-11-03,-15,Public Transport,Egged,246.87
2021-11-03,-534,Supermarket,Rami Levi,-287.13
2021-11-04,-30,Newspapers,Yediot Aharonot,-317.13
2021-11-06,-150,Cellular,Partner,-467.13
2021-11-06,-220,Gas,Paz,-687.13
2021-11-07,-629,Supermarket,Rami Levi,-1316.13
2021-11-08,-174,Various Expenses,Yellow,-1490.13
2021-11-09,-501,Electricity,Electric Company,-1991.13
2021-11-10,-300,Saving,Exellence Investments,-2291.13
2021-11-10,-240,"Pharmacy, Specialist Doctor",Good Pharm,-2531.13
2021-11-10,7904,Income,A.D Services,5372.87
2021-11-10,6000,Income,Salary 2,11372.87
2021-11-11,-3600,Mortgage / Rent,Avi Kuperman,7772.87
2021-11-11,-42,Restaurants,Hummus Eliyahu,7730.87
2021-11-13,-170,Restaurants,Dominos Pizza,7560.87
2021-11-13,-187,Water,Ein Cramim,7373.87
2021-11-13,-170,Entertainments,Hot Movies,7203.87
2021-11-14,-56,Supermarket,Osher Ad,7147.87
2021-11-15,-400,Cash withdrawals,ATM,6747.87
2021-11-15,-76,Various Expenses,Colbo Dani,6671.87
2021-11-15,-554,Supermarket,Rami Levi,6117.87
2021-11-15,-195,Restaurants,Vivino,5922.87
2021-11-16,-644,Supermarket,Shufersal,5278.87
2021-11-18,-97,Donations & Taxes,Pithon Lev,5181.87
2021-11-19,-65,Health Insurance / HMO,Clalit,5116.87
2021-11-19,-196,Restaurants,Dominos Pizza,4920.87
2021-11-19,-249,Health Insurance / HMO,Harel,4671.87
2021-11-20,-775,Property Tax,Carmiel Municipality,3896.87
2021-11-20,-141,Entertainments,Hot Movies,3755.87
2021-11-22,-227.7,Gas,Sonol,3528.17
2021-11-23,-204.6,Gas,Sonol,3323.57
2021-11-24,-380,Car Insurance,AIG,2943.57
2021-11-24,-38,Restaurants,Hummus Eliyahu,2905.57
2021-11-26,-200,Cash withdrawals,ATM,2705.57
2021-11-26,-120,Education & Classes,Gym,2585.57
2021-11-26,-664,Education & Classes,Success - Private High-School,1921.57
2021-11-27,-136,Clothing,Crazy Line,1785.57
2021-11-29,-89,Internet,Bezeq,1696.57
2021-11-30,-36,Public Transport,Nativ Express,1660.57
2021-11-30,-30,Public Transport,Nativ Express,1630.57
2021-11-30,-31,Supermarket,Tiv Taam,1599.57
2021-12-01,-16,Bank Commissions,Bank Hapoalom,1583.57
2021-12-01,-190,"Pharmacy, Specialist Doctor",Be,1393.57
2021-12-01,-180,Public Transport,Egged,1213.57
2021-12-01,-180,Office Supplies,Ofiice Depot,1033.57
2021-12-01,-523,Supermarket,Tiv Taam,510.57
2021-12-02,-47,TV,Netflix,463.57
2021-12-03,-84,Donations & Taxes,Latet,379.57
2021-12-04,-200,Cash withdrawals,ATM,179.57
2021-12-04,-42,Restaurants,Shawarma Shemesh,137.57
2021-12-04,-30,Newspapers,Yediot Aharonot,107.57
2021-12-05,-36,Restaurants,Shawarma Shemesh,71.57
2021-12-05,-603,Supermarket,Victory,-531.43
2021-12-06,-146,Entertainments,Cinima City,-677.43
2021-12-06,-22,Public Transport,Egged,-699.43
2021-12-06,-514,Supermarket,Osher Ad,-1213.43
2021-12-06,-150,Cellular,Partner,-1363.43
2021-12-06,-55,Supermarket,Shufersal,-1418.43
2021-12-10,-210.9,Gas,Alon,-1629.33
2021-12-10,-300,Saving,Exellence Investments,-1929.33
2021-12-10,-30,Various Expenses,Mifgash HaDerekh,-1959.33
2021-12-10,8045,Income,A.D Services,6085.67
2021-12-10,6000,Income,Salary 2,12085.67
2021-12-11,-3600,Mortgage / Rent,Avi Kuperman,8485.67
2021-12-11,-30,Supermarket,Shufersal,8455.67
2021-12-13,-182,Restaurants,Greg Coffee,8273.67
2021-12-17,-164,Various Expenses,Yellow,8109.67
2021-12-18,-206.46,Gas,Alon,7903.21
2021-12-19,-400,Cash withdrawals,ATM,7503.21
2021-12-19,-65,Health Insurance / HMO,Clalit,7438.21
2021-12-19,-249,Health Insurance / HMO,Harel,7189.21
2021-12-21,-16,Public Transport,Kavim,7173.21
2021-12-23,-163,Entertainments,Cinima City,7010.21
2021-12-23,-43,Various Expenses,Mifgash HaDerekh,6967.21
2021-12-24,-380,Car Insurance,AIG,6587.21
2021-12-24,-224.22,Gas,Alon,6362.99
2021-12-26,-120,Education & Classes,Gym,6242.99
2021-12-26,-644,Education & Classes,Success - Private High-School,5598.99
2021-12-27,-113,Various Expenses,Alonit,5485.99
2021-12-27,-193,Restaurants,Japanica,5292.99
2021-12-28,-155,Restaurants,BBB,5137.99
2021-12-28,-508,Supermarket,Osher Ad,4629.99
2021-12-29,-145,Various Expenses,Alonit,4484.99
2021-12-29,-89,Internet,Bezeq,4395.99
2021-12-29,-66,Supermarket,Osher Ad,4329.99
2021-12-30,-181,Entertainments,Hot Movies,4148.99
2021-12-31,-400,Cash withdrawals,ATM,3748.99
2021-12-31,-138,Clothing,Fox,3610.99
2022-01-01,-15,Bank Commissions,Bank Hapoalom,3595.99
2022-01-02,-181,Restaurants,Dominos Pizza,3414.99
2022-01-02,-47,TV,Netflix,3367.99
2022-01-03,-180,Public Transport,Egged,3187.99
2022-01-04,-400,Cash withdrawals,ATM,2787.99
2022-01-04,-24,Public Transport,Egged,2763.99
2022-01-04,-207,Restaurants,Japanica,2556.99
2022-01-04,-25,Public Transport,Nativ Express,2531.99
2022-01-04,-30,Newspapers,Yediot Aharonot,2501.99
2022-01-05,-172,Entertainments,Escape Room,2329.99
2022-01-05,-38,Restaurants,Falafel Shef,2291.99
2022-01-05,-161,Various Expenses,So Good,2130.99
2022-01-05,-569,Supermarket,Tiv Taam,1561.99
2022-01-06,-150,Cellular,Partner,1411.99
2022-01-07,-31,Supermarket,Shufersal,1380.99
2022-01-07,-148,Various Expenses,Yellow,1232.99
2022-01-09,-187,Water,Ein Cramim,1045.99
2022-01-10,-200,Cash withdrawals,ATM,845.99
2022-01-10,-300,Saving,Exellence Investments,545.99
2022-01-10,8290,Income,A.D Services,8835.99
2022-01-10,6000,Income,Salary 2,14835.99
2022-01-11,-3600,Mortgage / Rent,Avi Kuperman,11235.99
2022-01-11,-573,Electricity,Electric Company,10662.99
2022-01-12,-212.44,Gas,Delek,10450.55
2022-01-14,-576,Supermarket,Tiv Taam,9874.55
2022-01-16,-128,Various Expenses,Alonit,9746.55
2022-01-16,-35,Restaurants,Hummus Eliyahu,9711.55
2022-01-16,-67,Supermarket,Osher Ad,9644.55
2022-01-16,-546,Supermarket,Shufersal,9098.55
2022-01-18,-106,Clothing,Fox,8992.55
2022-01-19,-65,Health Insurance / HMO,Clalit,8927.55
2022-01-19,-249,Health Insurance / HMO,Harel,8678.55
2022-01-20,-775,Property Tax,Carmiel Municipality,7903.55
2022-01-21,-247,"Pharmacy, Specialist Doctor",Be,7656.55
2022-01-21,-155,Entertainments,Escape Room,7501.55
2022-01-22,-162,Restaurants,Vivino,7339.55
2022-01-23,-21,Public Transport,Kavim,7318.55
2022-01-24,-380,Car Insurance,AIG,6938.55
2022-01-24,-209.05,Gas,Alon,6729.5
2022-01-24,-136,Various Expenses,Yellow,6593.5
2022-01-25,-214.7,Gas,Paz,6378.8
2022-01-26,-120,Education & Classes,Gym,6258.8
2022-01-26,-661,Education & Classes,Success - Private High-School,5597.8
2022-01-27,-1999,Vacations,Bereshit,3598.8
2022-01-29,-89,Internet,Bezeq,3509.8
2022-01-29,-47,Supermarket,Victory,3462.8
2022-01-30,-184,Entertainments,Cinima City,3278.8
2022-01-30,-612,Supermarket,Osher Ad,2666.8